100_-Yummy-Banana-Bread-Recipezaar	100% Yummy Banana Bread
100_stroke-Banana-Bread-Recipezaar	100-Stroke Banana Bread
1st-Place-Banana-Nut-Bread-Recipezaar	1st Place Banana Nut Bread
5-Minute-Banana-Bread-Food_com-178773	5 Minute Banana Bread
5-Minute-Banana-Bread_-Banana-Muffin-Batter-MyRecipes-240407	5 Minute Banana Bread/ Banana Muffin Batter
A-Bit-of-Everything-Banana-Bread-Food_com-78988	A Bit of Everything Banana Bread
A-Healthier-Banana_s-Foster-Pseudo-Bread-Pudding-Food_com-280400	A Healthier Banana's Foster Pseudo Bread Pudding
A-Little-More-Than-a-Banana-Bread-Food_com-178005	A Little More Than a Banana Bread
A-Winning-Banana-Nut-Bread-Food_com-85142	A Winning Banana Nut Bread
Abm-Banana-Yeast-Bread-Food_com-69126	Abm Banana Yeast Bread
Aidan_s-Banana-Nut-Bread-Recipezaar	Aidan's Banana Nut Bread
Alice_s-Banana-Bread-Recipe-Chow-57374	Alice's Banana Bread Recipe
All-Bran-Banana-Bread-Food_com-287780	All Bran Banana Bread
All-Bran-Banana-Bread-Recipezaar	All Bran Banana Bread
All-Bran-Banana-Walnut-Bread-AllRecipes-39726	All-Bran Banana Walnut Bread
Allie_s-Spicy-Banana-Bread-Recipezaar	Allie's Spicy Banana Bread
Allison_s-Banana-Bread-Recipezaar	Allison's Banana Bread
Almond-Butter-And-Finger-Bananas-On-Fruit-Bread-Epicurious	Almond Butter and Finger Bananas on Fruit Bread
Almost-Fat-Free-Banana-Bread-Muffins-Recipezaar	Almost Fat Free Banana Bread Muffins
Almost-No-Fat-Banana-Bread-Allrecipes	Almost No Fat Banana Bread
Almost-No-Fat-Banana-Bread-Food_com-175689	Almost No Fat Banana Bread
Almost-No-Fat-Banana-Bread-Recipezaar	Almost No Fat Banana Bread
Almost-Vegan-Banana-Bread-Food_com-290772	Almost Vegan Banana Bread
Aloha-Hawaiian-Banana-Bread-Recipezaar	Aloha Hawaiian Banana Bread
Amazing-Banana-Bread-Food_com-147234	Amazing Banana Bread
Amazing-Banana-Bread-Recipezaar	Amazing Banana Bread
Amazing-Banana_nut-Bread-Recipezaar	Amazing Banana-Nut Bread
Amazing_-Banana-Bread-Food_com-98596	Amazing!!!! Banana Bread
Amish-Friendship-Banana-Nut-Bread-Allrecipes	Amish Friendship Banana Nut Bread
Amy-Grants-Grandma-Grant-Banana-Nut-Bread-Food_com-149540	Amy Grants Grandma Grant Banana Nut Bread
Amy-Grants-Grandma-Grant-Banana-Nut-Bread-Food_com-157661	Amy Grants Grandma Grant Banana Nut Bread
Amy_s-Banana-Bread-Recipezaar	Amy's Banana Bread
Amy_s-Yummy-Banana-Bread-_Bread-Machine_-Food_com-132288	Amy's Yummy Banana Bread (Bread Machine)
Angie_s-Low-Cal-Low-Fat-Banana-Bread-Recipezaar	Angie's Low Cal Low Fat Banana Bread
Angie_s-To-Die-For-Banana-Bread-AllRecipes-38657	Angie's To-Die-For Banana Bread
Anne_s-Banana-Bread-Recipezaar	Anne's Banana Bread
Ann_s-Banana-Bread-Recipezaar	Ann's Banana Bread
Another-Banana-Bread-Recipezaar	Another Banana Bread
Another-Vegan-Banana-Bread-Food_com-76647	Another Vegan Banana Bread
Apple-Banana-Bread-Food_com-74698	Apple Banana Bread
Apple-Banana-Bread-Recipezaar	Apple Banana Bread
Apple-Banana-Bread-Recipezaar_1	Apple Banana Bread
Apple-Banana-Bread-Recipezaar_2	Apple Banana Bread
Apple-Butter-Banana-Bread-Food_com-125681	Apple-Butter Banana Bread
Applesauce-Banana-Bread-Food_com-174862	Applesauce Banana Bread
Applesauce-Banana-Bread-Recipezaar	Applesauce Banana Bread
Applesauce-Banana-Bread-Recipezaar_1	Applesauce Banana Bread
Applesauce-Banana-Bread-Recipezaar_2	Applesauce Banana Bread
Apricot-Banana-Bread-Recipezaar	Apricot Banana Bread
Apricot_-Banana-and-Buttermilk-Bread-Food_com-190332	Apricot, Banana and Buttermilk Bread
Ashley_s-Healthy-_whole-Wheat-Oatmeal_-Banana-Bread-Recipezaar	Ashley's Healthy (Whole Wheat Oatmeal) Banana Bread
Asian-Banana-Chai-Bread-Recipezaar	Asian Banana Chai Bread
Aunt-Carrie_s-Banana-Bread-Recipezaar	Aunt Carrie's Banana Bread
Aunt-Holly_s-Banana-Bread-Epicurious	Aunt Holly's Banana Bread
Aunt-Muriel_s-Banana-Bread-Recipezaar	Aunt Muriel's Banana Bread
Aunt-Pat_s-Banana-Bread-Food_com-110220	Aunt Pat's Banana Bread
Aunt-Peg_s-Banana-Bread-Recipezaar	Aunt Peg's Banana Bread
Auntie-Bernice_s-Banana-Bread-Food_com-84570	Auntie Bernice's Banana Bread
Awesome-Banana-Bread-Recipezaar	Awesome Banana Bread
Awesome-Banana-Bread-Recipezaar_1	Awesome Banana Bread
Awesome-Raspberry-Banana-Bread-Recipezaar	Awesome Raspberry Banana Bread
Baby-Bear_s-Whole-Wheat-Banana-Bread-Recipezaar	Baby Bear's Whole Wheat Banana Bread
Baby-Food-Banana-Bread-Recipezaar	Baby Food Banana Bread
Back-in-Business-Banana-Bread-Pudding-Food-Network-284568	Back in Business Banana Bread Pudding
Baileys-And-Banana-Bread-And-Butter-Pudding-Recipezaar	Baileys and Banana Bread and Butter Pudding
Bake-Sale-Banana-Bread-Recipezaar	Bake Sale Banana Bread
Baked-_-Banana-Bread_-Oatmeal-Recipezaar	Baked " Banana Bread" Oatmeal
Banana----Oatmeal---Pecan-Bread-Food_com-109263	Banana -  Oatmeal - Pecan Bread
Banana-and-Apricot-Bread-Food_com-117192	Banana and Apricot Bread
Banana-and-Chocolate-Bread-Food_com-116472	Banana and Chocolate Bread
Banana-and-Chocolate-Bread-Pudding-AllRecipes	Banana and Chocolate Bread Pudding
Banana-And-Chocolate-Bread-Pudding-Food-Network	Banana and Chocolate Bread Pudding
Banana-and-Chocolate-Chip-Bread-I-Adore-Food-55269	Banana and Chocolate Chip Bread
Banana-and-Ginger-Tea-Bread-Food_com-114348	Banana and Ginger Tea Bread
Banana-And-Mango-Bread-Recipezaar	Banana and Mango Bread
Banana-And-Soya-Bread-Recipezaar	Banana and Soya Bread
Banana-And-Strawberry-Bread-Recipezaar	Banana and Strawberry Bread
Banana-and-vanilla-bread-302521	Banana and vanilla bread
Banana-Apple-Bread-AllRecipes-201139	Banana Apple Bread
Banana-Apple-Bread-Recipezaar	Banana Apple Bread
Banana-Apple-Bread-_From-the-Sweet-Melissa-Bakery_-Food_com-178509	Banana Apple Bread (From the Sweet Melissa Bakery)
Banana-Apple-Nut-Bread-Recipezaar	Banana Apple Nut Bread
Banana-Applesauce-Bread-Food_com-131391	Banana Applesauce Bread
Banana-Applesauce-Bread-Food_com-149326	Banana Applesauce Bread
Banana-Applesauce-Bread-Food_com-168753	Banana Applesauce Bread
Banana-Banana-Bread-Allrecipes	Banana Banana Bread
Banana-Banana-Bread-Recipezaar	Banana Banana Bread
Banana-Banana-Nut-Bread-Recipezaar	Banana Banana Nut Bread
Banana-Barley-Bread-Recipezaar	Banana Barley Bread
Banana-Bead-for-the-Bread-Machine-Food_com-107815	Banana Bead for the Bread Machine
Banana-Berry-Bread-Recipezaar	Banana Berry Bread
Banana-Blueberry-Bread-My-Recipes	Banana Blueberry Bread
Banana-Blueberry-Bread-Recipezaar	Banana Blueberry Bread
Banana-Blueberry-Bread-Recipezaar_1	Banana Blueberry Bread
Banana-Blueberry-Bread-Recipezaar_2	Banana Blueberry Bread
Banana-Blueberry-Chocolate-Chip-Bread-Recipezaar	Banana Blueberry Chocolate Chip Bread
Banana-Blueberry-Oatmeal-Bread-Food_com-110742	Banana Blueberry Oatmeal Bread
Banana-Blueberry-Pistachio-Nut-Bread-Recipezaar	Banana Blueberry Pistachio Nut Bread
Banana-Bonanza-Bread-_vegan_-Recipezaar	Banana Bonanza Bread (Vegan)
Banana-Bran-Bread-Food_com-99763	Banana Bran Bread
Banana-Bran-Bread-Recipezaar	Banana Bran Bread
Banana-Bran-Breakfast-Bread-Recipezaar	Banana Bran Breakfast Bread
Banana-Bran-Zucchini-Bread-Allrecipes	Banana Bran Zucchini Bread
Banana-Bran-Zucchini-Bread-Recipezaar	Banana Bran Zucchini Bread
Banana-Bread---Lightened-up---Spelt-_-Vegan-Food_com-155606	Banana Bread - Lightened up - Spelt &amp; Vegan
Banana-Bread---Low-Fat_-High-Fiber-Food_com-143365	Banana Bread - Low Fat, High Fiber
Banana-Bread---Runner_s-World-Food_com-150598	Banana Bread - Runner's World
Banana-Bread---Sugar-Free-Food_com-185906	Banana Bread - Sugar Free
Banana-Bread-1-Recipezaar	Banana Bread 1
Banana-Bread-1978-Recipezaar	Banana Bread 1978
Banana-Bread-3-Recipezaar	Banana Bread 3
Banana-bread-307554	Banana Bread
Banana-Bread-And-Butter-Pudding-Recipezaar	Banana Bread and Butter Pudding
Banana-Bread-Bars-with-Brown-Butter-Frosting-CassieDunbar-296431	Banana Bread Bars with Brown Butter Frosting
Banana-Bread-Biscotti-Food_com-70795	Banana Bread Biscotti
Banana-Bread-Bites-Food_com-288298	Banana Bread Bites
Banana-Bread-Blast-Food_com-92364	Banana Bread Blast
Banana-Bread-Bruschetta-My-Recipes	Banana Bread Bruschetta
Banana-Bread-By-Williams_sonoma-Recipezaar	Banana Bread by Williams-Sonoma
Banana-Bread-Cobbler-MyRecipes-246880	Banana Bread Cobbler
Banana-Bread-Cobbler-With-Streusel-Topping-Food_com-62661	Banana Bread Cobbler With Streusel Topping
Banana-Bread-Cockaigne-Recipezaar	Banana Bread Cockaigne
Banana-Bread-Cookies-Allrecipes	Banana Bread Cookies
Banana-Bread-Cookies-Ii-Recipezaar	Banana Bread Cookies II
Banana-Bread-Cookies-Recipezaar	Banana Bread Cookies
Banana-Bread-Cookies-Recipezaar_1	Banana Bread Cookies
Banana-Bread-Cookies-Recipezaar_2	Banana Bread Cookies
Banana-Bread-Cookies-Recipezaar_3	Banana Bread Cookies
Banana-Bread-Crumb-Pudding-Allrecipes	Banana Bread Crumb Pudding
Banana-Bread-Crumb-Pudding-Recipezaar	Banana Bread Crumb Pudding
Banana-Bread-Dip-Recipezaar	Banana Bread Dip
Banana-Bread-Epicurious	Banana Bread
Banana-Bread-Epicurious_1	Banana Bread
Banana-Bread-Food-Network	Banana Bread
Banana-Bread-Food-Network_1	Banana Bread
Banana-Bread-Food-Network_2	Banana Bread
Banana-Bread-Food-Network_3	Banana Bread
Banana-Bread-Food_com-108910	Banana Bread
Banana-Bread-Food_com-126279	Banana Bread
Banana-Bread-Food_com-127567	Banana Bread
Banana-Bread-Food_com-129673	Banana Bread
Banana-Bread-Food_com-130324	Banana Bread
Banana-Bread-Food_com-130659	Banana Bread
Banana-Bread-Food_com-132420	Banana Bread
Banana-Bread-Food_com-133661	Banana Bread
Banana-Bread-Food_com-134701	Banana Bread
Banana-Bread-Food_com-135219	Banana Bread
Banana-Bread-Food_com-140496	Banana Bread
Banana-Bread-Food_com-140863	Banana Bread
Banana-Bread-Food_com-141974	Banana Bread
Banana-Bread-Food_com-143761	Banana Bread
Banana-Bread-Food_com-144700	Banana Bread
Banana-Bread-Food_com-147420	Banana Bread
Banana-Bread-Food_com-148420	Banana Bread
Banana-Bread-Food_com-149615	Banana Bread
Banana-Bread-Food_com-153549	Banana Bread
Banana-Bread-Food_com-156264	Banana Bread
Banana-Bread-Food_com-163719	Banana Bread
Banana-Bread-Food_com-166634	Banana Bread
Banana-Bread-Food_com-167129	Banana Bread
Banana-Bread-Food_com-171893	Banana Bread
Banana-Bread-Food_com-188564	Banana Bread
Banana-Bread-Food_com-188671	Banana Bread
Banana-Bread-Food_com-62903	Banana Bread
Banana-Bread-Food_com-72134	Banana Bread
Banana-Bread-Food_com-75581	Banana Bread
Banana-Bread-Food_com-79435	Banana Bread
Banana-Bread-Food_com-83076	Banana Bread
Banana-Bread-Food_com-83460	Banana Bread
Banana-Bread-Food_com-88013	Banana Bread
Banana-Bread-Food_com-91849	Banana Bread
Banana-Bread-Food_com-94212	Banana Bread
Banana-Bread-Food_com-95386	Banana Bread
Banana-Bread-For-Vegans-Recipezaar	Banana Bread for Vegans
Banana-Bread-Foster-Recipezaar	Banana Bread Foster
Banana-Bread-French-Toast-Allrecipes	Banana Bread French Toast
Banana-Bread-French-Toast-Food_com-118677	Banana Bread French Toast
Banana-Bread-French-Toast-Food_com-135213	Banana Bread French Toast
Banana-Bread-French-Toast-MyRecipes-265455	Banana Bread French Toast
Banana-Bread-French-Toast-Recipe-Leite_s-Culinaria-203512	Banana Bread French Toast Recipe
Banana-Bread-French-Toast-With-Creme-Fraiche-Food_com-171108	Banana Bread French Toast With Cr&egrave;me Fra&icirc;che
Banana-Bread-from-Betty-Crocker-Food_com-72712	Banana Bread from Betty Crocker
Banana-Bread-From-Granny_s-Book-Recipezaar	Banana Bread from Granny's Book
Banana-Bread-from-the-New-York-Times-Natural-Foods-Cookbook-Food_com-147547	Banana Bread from the New York Times Natural Foods Cookbook
Banana-Bread-I-Allrecipes	Banana Bread I
Banana-Bread-Ice-Cream-Serious-Eats-280697	Banana Bread Ice Cream
Banana-Bread-Ii-Allrecipes	Banana Bread II
Banana-Bread-II-Food_com-189415	Banana Bread II
Banana-Bread-Iii-Allrecipes	Banana Bread III
Banana-Bread-In-A-Jar-Recipezaar	Banana Bread in a Jar
Banana-Bread-In-A-Jar-Recipezaar_1	Banana Bread in a Jar
Banana-Bread-Iv-Allrecipes	Banana Bread IV
Banana-Bread-Latte-Recipezaar	Banana Bread Latte
Banana-Bread-Lite-My-Recipes	Banana Bread Lite
Banana-Bread-Low-Fat-Recipezaar	Banana Bread Low Fat
Banana-Bread-Man_s-Banana-Bread-Recipezaar	Banana Bread Man&rsquo;s Banana Bread
Banana-Bread-Martha-Stewart-191095	Banana Bread
Banana-Bread-Mini-Loaf-Recipezaar	Banana Bread Mini Loaf
Banana-Bread-Muffins-Food_com-99712	Banana Bread Muffins
Banana-Bread-Muffins-Low-Carb-Low-Sugar-Recipezaar	Banana Bread Muffins Low Carb Low Sugar
Banana-Bread-Muffins-Recipezaar	Banana Bread Muffins
Banana-Bread-Muffins-Recipezaar_1	Banana Bread Muffins
Banana-Bread-My-Recipes	Banana Bread
Banana-Bread-My-Recipes_1	Banana Bread
Banana-Bread-MyRecipes-204810	Banana Bread
Banana-Bread-MyRecipes-236128	Banana Bread
Banana-Bread-MyRecipes-238875	Banana Bread
Banana-Bread-MyRecipes-241420	Banana Bread
Banana-Bread-MyRecipes-241665	Banana Bread
Banana-Bread-MyRecipes-242110	Banana Bread
Banana-Bread-MyRecipes-247453	Banana Bread
Banana-Bread-MyRecipes-247479	Banana Bread
Banana-Bread-MyRecipes-247674	Banana Bread
Banana-Bread-MyRecipes-247768	Banana Bread
Banana-Bread-MyRecipes-247870	Banana Bread
banana-bread-MyRecipes-263622	banana bread
Banana-bread-MyRecipes-265872	Banana bread
Banana-bread-MyRecipes-281218	Banana bread
Banana-Bread-MyRecipes-281283	Banana Bread
Banana-Bread-No-Fat-Less-Sugar-Food_com-187213	Banana Bread No Fat Less Sugar
Banana-Bread-Oatmeal-Recipezaar	Banana Bread Oatmeal
Banana-Bread-Oatmeal-Recipezaar_1	Banana Bread Oatmeal
Banana-Bread-Oatmeal-Recipezaar_2	Banana Bread Oatmeal
Banana-Bread-Once-Upon-A-Chef-199983	Banana Bread
Banana-Bread-Pancakes-Food_com-161293	Banana Bread Pancakes
Banana-Bread-Pancakes-Recipezaar	Banana Bread Pancakes
Banana-Bread-Pancakes-With-Cinnamon-Maple-Syrup-Food_com-117645	Banana Bread Pancakes With Cinnamon Maple Syrup
Banana-Bread-Pie-Food_com-139406	Banana Bread Pie
Banana-Bread-Protein-Pancakes-Food_com-130527	Banana Bread Protein Pancakes
Banana-Bread-Pudding-Food_com-85543	Banana Bread Pudding
Banana-Bread-Pudding-from-Williams-Sonoma-Food_com-71123	Banana Bread Pudding from Williams Sonoma
Banana-Bread-Pudding-Martha-Stewart-194203	Banana Bread Pudding
Banana-Bread-Pudding-Recipezaar	Banana Bread Pudding
Banana-Bread-Pudding-Recipezaar_3	Banana Bread Pudding
Banana-Bread-Pudding-Recipezaar_4	Banana Bread Pudding
Banana-Bread-Pudding-With-Caramel-Sauce-My-Recipes	Banana Bread Pudding with Caramel Sauce
Banana-Bread-Pudding-with-Rum-Sauce-Epicurious-48911	Banana Bread Pudding with Rum Sauce
Banana-Bread-Pudding-W_-Wheat-Bread-Food_com-142718	Banana Bread Pudding W/ Wheat Bread
Banana-Bread-Recipe-Chow-48737	Banana Bread Recipe
Banana-Bread-Recipe-Leite_s-Culinaria-40955	Banana Bread Recipe
Banana-Bread-Recipezaar	Banana Bread
Banana-Bread-Recipezaar_1	Banana Bread
Banana-Bread-Recipezaar_10	Banana Bread
Banana-Bread-Recipezaar_100	Banana Bread
Banana-Bread-Recipezaar_101	Banana Bread
Banana-Bread-Recipezaar_102	Banana Bread
Banana-Bread-Recipezaar_103	Banana Bread
Banana-Bread-Recipezaar_104	Banana Bread
Banana-Bread-Recipezaar_105	Banana Bread
Banana-Bread-Recipezaar_106	Banana Bread
Banana-Bread-Recipezaar_107	Banana Bread
Banana-Bread-Recipezaar_108	Banana Bread
Banana-Bread-Recipezaar_109	Banana Bread
Banana-Bread-Recipezaar_11	Banana Bread
Banana-Bread-Recipezaar_110	Banana Bread
Banana-Bread-Recipezaar_111	Banana Bread
Banana-Bread-Recipezaar_112	Banana Bread
Banana-Bread-Recipezaar_113	Banana Bread
Banana-Bread-Recipezaar_114	Banana Bread
Banana-Bread-Recipezaar_115	Banana Bread
Banana-Bread-Recipezaar_116	Banana Bread
Banana-Bread-Recipezaar_117	Banana Bread
Banana-Bread-Recipezaar_118	Banana Bread
Banana-Bread-Recipezaar_119	Banana Bread
Banana-Bread-Recipezaar_12	Banana Bread
Banana-Bread-Recipezaar_120	Banana Bread
Banana-Bread-Recipezaar_121	Banana Bread
Banana-Bread-Recipezaar_122	Banana Bread
Banana-Bread-Recipezaar_124	Banana Bread
Banana-Bread-Recipezaar_125	Banana Bread
Banana-Bread-Recipezaar_126	Banana Bread
Banana-Bread-Recipezaar_127	Banana Bread
Banana-Bread-Recipezaar_128	Banana Bread
Banana-Bread-Recipezaar_129	Banana Bread
Banana-Bread-Recipezaar_13	Banana Bread
Banana-Bread-Recipezaar_130	Banana Bread
Banana-Bread-Recipezaar_131	Banana Bread
Banana-Bread-Recipezaar_132	Banana Bread
Banana-Bread-Recipezaar_133	Banana Bread
Banana-Bread-Recipezaar_134	Banana Bread
Banana-Bread-Recipezaar_135	Banana Bread
Banana-Bread-Recipezaar_136	Banana Bread
Banana-Bread-Recipezaar_137	Banana Bread
Banana-Bread-Recipezaar_138	Banana Bread
Banana-Bread-Recipezaar_14	Banana Bread
Banana-Bread-Recipezaar_15	Banana Bread
Banana-Bread-Recipezaar_16	Banana Bread
Banana-Bread-Recipezaar_17	Banana Bread
Banana-Bread-Recipezaar_18	Banana Bread
Banana-Bread-Recipezaar_19	Banana Bread
Banana-Bread-Recipezaar_2	Banana Bread
Banana-Bread-Recipezaar_20	Banana Bread
Banana-Bread-Recipezaar_21	Banana Bread
Banana-Bread-Recipezaar_22	Banana Bread
Banana-Bread-Recipezaar_23	Banana Bread
Banana-Bread-Recipezaar_24	Banana Bread
Banana-Bread-Recipezaar_25	Banana Bread
Banana-Bread-Recipezaar_26	Banana Bread
Banana-Bread-Recipezaar_27	Banana Bread
Banana-Bread-Recipezaar_28	Banana Bread
Banana-Bread-Recipezaar_29	Banana Bread
Banana-Bread-Recipezaar_3	Banana Bread
Banana-Bread-Recipezaar_30	Banana Bread
Banana-Bread-Recipezaar_31	Banana Bread
Banana-Bread-Recipezaar_32	Banana Bread
Banana-Bread-Recipezaar_33	Banana Bread
Banana-Bread-Recipezaar_34	Banana Bread
Banana-Bread-Recipezaar_35	Banana Bread
Banana-Bread-Recipezaar_36	Banana Bread
Banana-Bread-Recipezaar_37	Banana Bread
Banana-Bread-Recipezaar_38	Banana Bread
Banana-Bread-Recipezaar_39	Banana Bread
Banana-Bread-Recipezaar_4	Banana Bread
Banana-Bread-Recipezaar_40	Banana Bread
Banana-Bread-Recipezaar_41	Banana Bread
Banana-Bread-Recipezaar_42	Banana Bread
Banana-Bread-Recipezaar_43	Banana Bread
Banana-Bread-Recipezaar_44	Banana Bread
Banana-Bread-Recipezaar_45	Banana Bread
Banana-Bread-Recipezaar_46	Banana Bread
Banana-Bread-Recipezaar_47	Banana Bread
Banana-Bread-Recipezaar_48	Banana Bread
Banana-Bread-Recipezaar_49	Banana Bread
Banana-Bread-Recipezaar_5	Banana Bread
Banana-Bread-Recipezaar_51	Banana Bread
Banana-Bread-Recipezaar_52	Banana Bread
Banana-Bread-Recipezaar_53	Banana Bread
Banana-Bread-Recipezaar_54	Banana Bread
Banana-Bread-Recipezaar_55	Banana Bread
Banana-Bread-Recipezaar_56	Banana Bread
Banana-Bread-Recipezaar_57	Banana Bread
Banana-Bread-Recipezaar_58	Banana Bread
Banana-Bread-Recipezaar_59	Banana Bread
Banana-Bread-Recipezaar_6	Banana Bread
Banana-Bread-Recipezaar_60	Banana Bread
Banana-Bread-Recipezaar_61	Banana Bread
Banana-Bread-Recipezaar_62	Banana Bread
Banana-Bread-Recipezaar_63	Banana Bread
Banana-Bread-Recipezaar_64	Banana Bread
Banana-Bread-Recipezaar_65	Banana Bread
Banana-Bread-Recipezaar_66	Banana Bread
Banana-Bread-Recipezaar_67	Banana Bread
Banana-Bread-Recipezaar_68	Banana Bread
Banana-Bread-Recipezaar_69	Banana Bread
Banana-Bread-Recipezaar_7	Banana Bread
Banana-Bread-Recipezaar_70	Banana Bread
Banana-Bread-Recipezaar_71	Banana Bread
Banana-Bread-Recipezaar_72	Banana Bread
Banana-Bread-Recipezaar_74	Banana Bread
Banana-Bread-Recipezaar_75	Banana Bread
Banana-Bread-Recipezaar_76	Banana Bread
Banana-Bread-Recipezaar_77	Banana Bread
Banana-Bread-Recipezaar_78	Banana Bread
Banana-Bread-Recipezaar_79	Banana Bread
Banana-Bread-Recipezaar_8	Banana Bread
Banana-Bread-Recipezaar_80	Banana Bread
Banana-Bread-Recipezaar_81	Banana Bread
Banana-Bread-Recipezaar_82	Banana Bread
Banana-Bread-Recipezaar_83	Banana Bread
Banana-Bread-Recipezaar_84	Banana Bread
Banana-Bread-Recipezaar_85	Banana Bread
Banana-Bread-Recipezaar_86	Banana Bread
Banana-Bread-Recipezaar_87	Banana Bread
Banana-Bread-Recipezaar_88	Banana Bread
Banana-Bread-Recipezaar_89	Banana Bread
Banana-Bread-Recipezaar_9	Banana Bread
Banana-Bread-Recipezaar_90	Banana Bread
Banana-Bread-Recipezaar_91	Banana Bread
Banana-Bread-Recipezaar_92	Banana Bread
Banana-Bread-Recipezaar_93	Banana Bread
Banana-Bread-Recipezaar_94	Banana Bread
Banana-Bread-Recipezaar_95	Banana Bread
Banana-Bread-Recipezaar_96	Banana Bread
Banana-Bread-Recipezaar_97	Banana Bread
Banana-Bread-Recipezaar_98	Banana Bread
Banana-Bread-Recipezaar_99	Banana Bread
Banana-Bread-Serious-Eats-200846	Banana Bread
Banana-Bread-Serious-Eats-46560	Banana Bread
Banana-Bread-Sticks-For-Baby-Recipezaar	Banana Bread Sticks For Baby
Banana-Bread-Sticks-Recipezaar	Banana Bread Sticks
Banana-Bread-Sticks-Recipezaar_1	Banana Bread Sticks
Banana-Bread-TasteOfHome	Banana Bread
Banana-Bread-The-Pioneer-Woman-Cooks-_-Ree-Drummond-41325	Banana Bread
Banana-Bread-Topped-With-Coconut-Recipezaar	Banana Bread Topped With Coconut
Banana-Bread-V-Allrecipes	Banana Bread V
Banana-Bread-Vi-Allrecipes	Banana Bread VI
Banana-Bread-Vii-Allrecipes	Banana Bread VII
Banana-Bread-Viii-Allrecipes	Banana Bread VIII
Banana-Bread-Waffles-With-Cinnamon-Butter-Recipezaar	Banana Bread Waffles With Cinnamon Butter
Banana-Bread-Walnuts-Food_com-138511	Banana Bread Walnuts
Banana-Bread-With-Cashews-_pao-De-Banana_-_-Portuguese-Mozambiq-Recipezaar	Banana Bread With Cashews (Pao De Banana) - Portuguese Mozambiq
Banana-Bread-With-Chocolate-Chips-and-Chocolate-Glaze-Food-Network-256627	Banana Bread With Chocolate Chips and Chocolate Glaze
Banana-Bread-With-Chocolate-Chips-And-Walnuts-Epicurious	Banana Bread with Chocolate Chips and Walnuts
Banana-Bread-With-Chocolate-Chips-And-Walnuts-Recipezaar	Banana Bread With Chocolate Chips and Walnuts
Banana-Bread-With-Chocolate-Chips-Food_com-79547	Banana Bread With Chocolate Chips
Banana-Bread-With-Chocolate-Chips-Recipezaar	Banana Bread With Chocolate Chips
Banana-Bread-With-Chocolate-Recipezaar	Banana Bread With Chocolate
Banana-Bread-With-Cinnamon-Crumble-Topping-Recipezaar	Banana Bread With Cinnamon Crumble Topping
Banana-Bread-with-Coconut-and-Pecans-Once-Upon-A-Chef-199956	Banana Bread with Coconut and Pecans
Banana-Bread-With-Coconut-Milk-Recipezaar	Banana Bread With Coconut Milk
Banana-Bread-With-Coconut-Rum-Food_com-185197	Banana Bread With Coconut Rum
Banana-Bread-With-Coconut-Rum-Recipezaar	Banana Bread With Coconut Rum
Banana-Bread-With-Oat_streusel-Topping-Allrecipes	Banana Bread with Oat-Streusel Topping
Banana-Bread-with-Pecans-Food-Network-272391	Banana Bread with Pecans
Banana-Bread-With-Protein-_Chickpeas_-Food_com-65799	Banana Bread With Protein (Chickpeas)
Banana-Bread-With-Splenda-Food_com-138142	Banana Bread With Splenda
Banana-Bread-With-Splenda-Recipezaar	Banana Bread With Splenda
Banana-Bread-With-Strawberry-Compote-Food_com-100827	Banana Bread With Strawberry Compote
Banana-Bread-With-Walnuts-And-Orange-Zest-Recipezaar	Banana Bread With Walnuts and Orange Zest
Banana-Bread-W_-Caramel-Almond-Crunch-Topping-Food_com-106647	Banana Bread W/ Caramel Almond Crunch Topping
Banana-Bread-W_chocolate-Chips-Recipezaar	Banana Bread W/Chocolate Chips
Banana-Bread-yet---Another-Recipe-by-Bill_its-Diff-Food_com-125679	Banana Bread yet   Another Recipe by Bill....its Diff
Banana-Bread-_-Quick-Bread-For-Machines-Allrecipes	Banana  Bread - Quick Bread for Machines
Banana-Bread-_-Quick-Bread-For-Machines-Recipezaar	Banana Bread - Quick Bread for Machines
Banana-Bread-_-The-Ultimate-Quick-And-Moist_-Recipezaar	Banana Bread - the Ultimate Quick and Moist!
Banana-Bread-_-Vegan-Recipezaar	Banana Bread - Vegan
Banana-Bread-_-Vegan-Recipezaar_1	Banana Bread - Vegan
Banana-Bread-_-With-Cauliflower_-Food_com-175299	Banana Bread ( With Cauliflower)
Banana-Bread-_-Yummy-Recipezaar	Banana Bread - Yummy
Banana-Bread-_America_s-Test-Kitchen_-Food_com-143770	Banana Bread (America's Test Kitchen)
Banana-Bread-_Diabetic_-Food_com-86495	Banana Bread (Diabetic)
Banana-Bread-_disneyland-Resort_-Recipezaar	Banana Bread (Disneyland Resort)
Banana-Bread-_egg-Free_-Recipezaar	Banana Bread (Egg Free)
Banana-Bread-_from-Africa_-Recipezaar_1	Banana Bread (from Africa!)
Banana-Bread-_Gluten-Free_-Food_com-138045	Banana Bread (Gluten-Free)
Banana-Bread-_king-Arthur_-Recipezaar	Banana Bread (King Arthur)
Banana-Bread-_low-Fat_-Low-Sugar_-Whole-Wheat_-Recipezaar	Banana Bread (Low Fat, Low Sugar, Whole Wheat)
Banana-Bread-_oat-And-Whole-Wheat_-Recipezaar	Banana Bread (Oat and Whole Wheat)
Banana-Bread-_pillsbury_s-Recipe_-Recipezaar	Banana Bread (Pillsbury's Recipe)
Banana-Bread-_Vegan_-Food_com-172466	Banana Bread (Vegan)
Banana-Bread-_vegan_-Recipezaar	Banana Bread (Vegan)
Banana-Bread-_Vegetarian_-Food_com-81434	Banana Bread (Vegetarian)
Banana-Bread-_with-A-Twist_-Recipezaar	Banana Bread (With a Twist)
Banana-Bread-_with-Cauliflower_-Recipezaar	Banana Bread (With Cauliflower)
Banana-Bread-_with-Chocolate-Chips_-Recipezaar	Banana Bread (With Chocolate Chips)
Banana-Bread-_yeast-Risen_-Recipezaar	Banana Bread (Yeast Risen)
Banana-Bread_-Banana-Bomb-Bread-Recipezaar	Banana Bread.... Banana Bomb Bread
Banana-Bread_-Diabetic-Food_com-87913	Banana Bread/ Diabetic
Banana-Bread_-Muffins-Recipezaar	Banana Bread/ Muffins
Banana-Bread_-No-Oil-Or-Butter-Recipezaar	Banana Bread- No Oil or Butter
Banana-Bread_bread-Pudding-Recipezaar	Banana Bread-Bread Pudding
Banana-Bread_cake-Recipezaar	Banana Bread/Cake
Banana-Breakfast-Bread-My-Recipes	Banana Breakfast Bread
Banana-Brioche-Bread-Pudding-Food-Network-228158	Banana Brioche Bread Pudding
Banana-Brioche-Monkey-Bread-with-Moloko-Milk-Stout-Butterscotch-and-Smoked-Almond-Toffee-Brittle-Martha-Stewart-220364	Banana Brioche Monkey Bread with Moloko Milk Stout Butterscotch and Smoked Almond Toffee Brittle
Banana-Bundt-Bread-Food_com-140004	Banana Bundt Bread
Banana-Butterscotch-Bread-AllRecipes	Banana Butterscotch Bread
Banana-Cake-or-Bread-Food_com-138085	Banana Cake or Bread
Banana-Caramel-Bread-Pudding-Recipezaar	Banana Caramel Bread Pudding
Banana-Carrot-Bread-Recipezaar	Banana Carrot Bread
Banana-Carrot-Bread-Recipezaar_1	Banana Carrot Bread
Banana-Carrot-Oatmeal-Bread-Food_com-157950	Banana Carrot Oatmeal Bread
Banana-Chai-Bread-Allrecipes	Banana Chai Bread
Banana-Chip-Bread-Recipezaar	Banana Chip Bread
Banana-Chip-Bread-_lower-Fat_-Recipezaar	Banana Chip Bread (Lower Fat)
Banana-Chocolate-Bread-Martha-Stewart-241052	Banana-Chocolate Bread
Banana-Chocolate-Chip-Bread-Pudding-_Vegan_-Food_com-145881	Banana Chocolate Chip Bread Pudding (Vegan)
Banana-Chocolate-Chip-Bread-Recipezaar	Banana Chocolate Chip Bread
Banana-Chocolate-Chip-Bread-_-Breadmaker-1-1_2-Lb_-Loaf_-Recipezaar	Banana Chocolate Chip Bread ( Breadmaker 1 1/2 Lb. Loaf)
Banana-Chocolate-Chip-Bread-_amish-Friendship-Bread-Starter_-Recipezaar	Banana Chocolate Chip Bread (Amish Friendship Bread Starter)
Banana-Chocolate-Chip-Nut-Bread-Recipezaar	Banana Chocolate Chip Nut Bread
Banana-Chocolate-Chunk-Bread-Recipezaar	Banana Chocolate Chunk Bread
Banana-Chocolate-Oatmeal-Bread-RecipeZaar-59338	Banana Chocolate Oatmeal Bread
Banana-Chocolate-Walnut-Bread-MyRecipes-244103	Banana-Chocolate-Walnut Bread
Banana-Coconut-Bread-Food_com-101789	Banana Coconut Bread
Banana-Coconut-Bread-Pudding-with-Rum-Sauce-Food_com-177324	Banana Coconut Bread Pudding with Rum Sauce
Banana-Coconut-Bread-Recipezaar	Banana Coconut Bread
Banana-Coconut-Bread-Recipezaar_1	Banana Coconut Bread
Banana-Coconut-Macadmia-Bread-Recipezaar	Banana Coconut Macadmia Bread
Banana-Coconut-Tea-Bread-Recipezaar	Banana Coconut Tea Bread
Banana-Coffee-Bread-MyRecipes-238433	Banana Coffee Bread
Banana-Cornflake-Bread-Recipezaar	Banana Cornflake Bread
Banana-Cranberry-Bread-Allrecipes	Banana Cranberry Bread
Banana-Cranberry-Bread-Recipezaar	Banana Cranberry Bread
Banana-Cranberry-Bread-Recipezaar_1	Banana Cranberry Bread
Banana-Cranberry-Walnut-Bread-Recipezaar	Banana Cranberry Walnut Bread
Banana-Cream-Cheese-Bread-Recipezaar	Banana Cream Cheese Bread
Banana-Cream-Of-Wheat-Bread-Recipezaar	Banana Cream of Wheat Bread
Banana-Crunch-Bread-Food_com-104564	Banana Crunch Bread
Banana-Date-Bread-MyRecipes-249139	Banana-Date Bread
Banana-Date-Flaxseed-Bread-Allrecipes	Banana Date Flaxseed Bread
Banana-Dulce-de-Leche-Bread-Pudding-Serious-Eats-200457	Banana-Dulce de Leche Bread Pudding
Banana-Eggnog-Bread-Pudding-with-Rum-Sauce-Food_com-66849	Banana-Eggnog Bread Pudding with Rum Sauce
Banana-Espresso-Bread-Pudding-Epicurious	Banana Espresso Bread Pudding
Banana-Farina-Bread-Recipezaar	Banana Farina Bread
Banana-Foster-Bread-Pudding-Food_com-107885	Banana Foster Bread Pudding
Banana-Foster_s-Bread-Pudding-Food_com-124661	Banana Foster's Bread Pudding
Banana-Friendship-Bread-Recipezaar	Banana Friendship Bread
Banana-Gumdrop-Bread-Recipezaar	Banana Gumdrop Bread
Banana-Lemon-Bread-Food_com-81994	Banana-Lemon Bread
Banana-Macadamia-Bread-Recipezaar	Banana Macadamia Bread
Banana-Macadamia-Nut-Bread-Allrecipes	Banana Macadamia Nut Bread
Banana-Macadamia-Nut-Bread-Recipezaar	Banana Macadamia Nut Bread
Banana-Macadamia-Nut-Bread-Recipezaar_1	Banana Macadamia Nut Bread
Banana-Macadamia-Nut-Bread-_abm_-Recipezaar	Banana Macadamia Nut Bread (Abm)
Banana-Maple-Nut-Bread-Allrecipes	Banana Maple Nut Bread
Banana-Maple-Pecan-Bread-Muffins-_Gluten-Free_-Food_com-169238	Banana Maple Pecan Bread Muffins (Gluten-Free)
Banana-Nana-Bread-Food_com-184890	Banana-Nana Bread
Banana-No_nut-Bread-Recipezaar	Banana No-Nut Bread
Banana-Nut-And-Ginger-Bread-Allrecipes	Banana Nut and Ginger Bread
Banana-Nut-Bread-Ala-Sam-Recipezaar	Banana Nut Bread Ala Sam
Banana-Nut-Bread-Baked-In-A-Jar-Allrecipes	Banana Nut Bread Baked in a Jar
Banana-Nut-Bread-Baked-In-A-Jar-Recipezaar	Banana Nut Bread Baked in a Jar
Banana-Nut-Bread-Butter-Recipezaar	Banana Nut Bread Butter
Banana-Nut-Bread-Coffee-Food_com-145108	Banana Nut Bread Coffee
Banana-Nut-Bread-Epicurious	Banana Nut Bread
Banana-Nut-Bread-Food-Network	Banana Nut Bread
Banana-Nut-Bread-Food-Network-212387	Banana Nut Bread
Banana-Nut-Bread-Food_com-111470	Banana Nut Bread
Banana-Nut-Bread-Food_com-115256	Banana-Nut Bread
Banana-Nut-Bread-Food_com-129436	Banana Nut Bread
Banana-Nut-Bread-Food_com-133350	Banana Nut Bread
Banana-Nut-Bread-Food_com-134049	Banana Nut Bread
Banana-Nut-Bread-Food_com-136126	Banana Nut Bread
Banana-Nut-Bread-Food_com-137979	Banana Nut Bread
Banana-Nut-Bread-Food_com-141283	Banana Nut Bread
Banana-Nut-Bread-Food_com-173745	Banana Nut Bread
Banana-Nut-Bread-Food_com-176052	Banana Nut Bread
Banana-Nut-Bread-Food_com-74614	Banana Nut Bread
Banana-Nut-Bread-Food_com-94038	Banana Nut Bread
Banana-Nut-Bread-for-the-Bread-Machine-Food_com-105215	Banana Nut Bread for the Bread Machine
Banana-Nut-Bread-For-The-Crock-Pot-Recipezaar	Banana Nut Bread  for the Crock Pot
Banana-Nut-Bread-I-Allrecipes	Banana Nut Bread I
Banana-Nut-Bread-Ii-Allrecipes	Banana Nut Bread II
Banana-Nut-Bread-Iii-Allrecipes	Banana Nut Bread III
Banana-Nut-Bread-Jam-Food_com-167844	Banana Nut Bread Jam
Banana-Nut-Bread-Jam-Recipezaar	Banana Nut Bread Jam
Banana-Nut-Bread-Made-by-Mom-Food_com-129823	Banana Nut Bread Made by Mom
Banana-Nut-Bread-My-Recipes	Banana Nut Bread
Banana-Nut-Bread-Recipezaar	Banana Nut Bread
Banana-Nut-Bread-Recipezaar_1	Banana Nut Bread
Banana-Nut-Bread-Recipezaar_10	Banana Nut Bread
Banana-Nut-Bread-Recipezaar_11	Banana Nut Bread
Banana-Nut-Bread-Recipezaar_12	Banana Nut Bread
Banana-Nut-Bread-Recipezaar_13	Banana Nut Bread
Banana-Nut-Bread-Recipezaar_14	Banana Nut Bread
Banana-Nut-Bread-Recipezaar_15	Banana Nut Bread
Banana-Nut-Bread-Recipezaar_16	Banana Nut Bread
Banana-Nut-Bread-Recipezaar_17	Banana Nut Bread
Banana-Nut-Bread-Recipezaar_18	Banana Nut Bread
Banana-Nut-Bread-Recipezaar_19	Banana Nut Bread
Banana-Nut-Bread-Recipezaar_2	Banana Nut Bread
Banana-Nut-Bread-Recipezaar_20	Banana Nut Bread
Banana-Nut-Bread-Recipezaar_21	Banana Nut Bread
Banana-Nut-Bread-Recipezaar_22	Banana Nut Bread
Banana-Nut-Bread-Recipezaar_23	Banana Nut Bread
Banana-Nut-Bread-Recipezaar_25	Banana Nut Bread
Banana-Nut-Bread-Recipezaar_26	Banana Nut Bread
Banana-Nut-Bread-Recipezaar_28	Banana Nut Bread
Banana-Nut-Bread-Recipezaar_29	Banana Nut Bread
Banana-Nut-Bread-Recipezaar_3	Banana Nut Bread
Banana-Nut-Bread-Recipezaar_30	Banana Nut Bread
Banana-Nut-Bread-Recipezaar_31	Banana Nut Bread
Banana-Nut-Bread-Recipezaar_32	Banana Nut Bread
Banana-Nut-Bread-Recipezaar_33	Banana Nut Bread
Banana-Nut-Bread-Recipezaar_34	Banana Nut Bread
Banana-Nut-Bread-Recipezaar_35	Banana Nut Bread
Banana-Nut-Bread-Recipezaar_36	Banana Nut Bread
Banana-Nut-Bread-Recipezaar_4	Banana Nut Bread
Banana-Nut-Bread-Recipezaar_5	Banana Nut Bread
Banana-Nut-Bread-Recipezaar_6	Banana Nut Bread
Banana-Nut-Bread-Recipezaar_7	Banana Nut Bread
Banana-Nut-Bread-Recipezaar_8	Banana Nut Bread
Banana-Nut-Bread-Recipezaar_9	Banana Nut Bread
Banana-Nut-Bread-TasteOfHome	Banana Nut Bread
Banana-Nut-Bread-With-Rum-Recipezaar	Banana Nut Bread With Rum
Banana-Nut-Bread-With-Yogurt-And-Whole-Wheat-Flour-Recipezaar	Banana Nut Bread With Yogurt and Whole Wheat Flour
Banana-Nut-Bread-_-Sugar-Free-Recipezaar	Banana Nut Bread - Sugar Free
Banana-Nut-Bread-_cake_-Recipezaar	Banana Nut Bread (Cake)
Banana-Nut-Bread-_Gift-Mix-in-a-Jar_-Food_com-133093	Banana Nut Bread (Gift Mix in a Jar)
Banana-Nut-Bread-_Healthy_-Low-Fat_-Low-Sugar_-Food_com-145985	Banana Nut Bread (Healthy, Low Fat, Low Sugar)
Banana-Nut-Bread-_lighter-Version_low_cal_-Recipezaar	Banana Nut Bread (Lighter Version-Low-Cal)
Banana-Nut-Bread_-Reduced-Sodium-Food_com-160697	Banana Nut Bread, Reduced Sodium
Banana-Nut-Cake_bread-Recipezaar	Banana Nut Cake/Bread
Banana-Nut-Chocolate-Chip-Bread-Recipezaar	Banana Nut Chocolate Chip Bread
Banana-Nut-Corn-Bread-Recipe-Taste-of-Home-44116	Banana-Nut Corn Bread Recipe
Banana-Nut-Cornbread-Recipezaar	Banana Nut Cornbread
Banana-Nut-Crunch-Bread-Recipezaar	Banana Nut Crunch Bread
Banana-Nut-Oatmeal-Bread-Allrecipes	Banana Nut Oatmeal Bread
Banana-Nut-Pina-Colada-Bread-Recipezaar	Banana Nut Pina Colada Bread
Banana-Nut-Pineapple-Bread-Recipezaar	Banana Nut Pineapple Bread
Banana-Nut-Raisin-Bread-For-Abm-Recipezaar	Banana Nut Raisin Bread for Abm
Banana-Nut-Yeast-Bread-TasteOfHome	Banana Nut Yeast Bread
Banana-Nut-Yeast-Bread-_bread-Machine_-Recipezaar	Banana Nut Yeast Bread (Bread Machine)
Banana-Nutmeg-Bread-Pudding-Recipezaar	Banana Nutmeg Bread Pudding
Banana-Oat-Bread-Pudding-Allrecipes	Banana Oat Bread Pudding
Banana-Oat-Bread-Recipezaar	Banana Oat Bread
Banana-Oat-Bread-Recipezaar_1	Banana Oat Bread
Banana-Oat-Bread-_bread-Machine_-Recipezaar	Banana Oat Bread (Bread Machine)
Banana-Oat-Coconut-Prune-Bread-Food_com-156666	Banana Oat Coconut Prune Bread
Banana-oatmeal-bread-299691	Banana Oatmeal Bread
Banana-Oatmeal-Bread-Allrecipes	Banana Oatmeal Bread
Banana-Oatmeal-Bread-Food_com-108215	Banana Oatmeal Bread
Banana-Oatmeal-Bread-Food_com-131709	Banana Oatmeal Bread
Banana-Oatmeal-Bread-Recipezaar	Banana Oatmeal Bread
Banana-Oatmeal-Bread-_-Bread-Machine-Recipezaar	Banana Oatmeal Bread - Bread Machine
Banana-Oatmeal-Honey-Bread-Recipezaar	Banana Oatmeal Honey Bread
Banana-Oatmeal-Muffins-_Or-Bread_-Food_com-81528	Banana Oatmeal Muffins (Or Bread)
Banana-Orange-Nut-Bread-Recipezaar	Banana Orange Nut Bread
Banana-Orange-Nutmeg-Bread-Recipezaar	Banana Orange Nutmeg Bread
Banana-Peach-Bread-Food_com-71664	Banana Peach Bread
Banana-Peach-Bread-Recipezaar	Banana Peach Bread
Banana-Peanut-Butter-Bread-Allrecipes	Banana Peanut Butter Bread
Banana-peanut-butter-bread-pudding-308249	Banana Peanut Butter Bread Pudding
Banana-Peanut-Butter-Bread-Recipezaar	Banana Peanut Butter Bread
Banana-Peanut-Butter-Bread-Recipezaar_1	Banana Peanut Butter Bread
Banana-Pear-Bread-With-Dates-Recipezaar	Banana Pear Bread With Dates
Banana-Pecan-Bread-By-Tyler-Florence-Recipezaar	Banana Pecan Bread by Tyler Florence
Banana-Pecan-Bread-Pudding-Food_com-60540	Banana Pecan Bread Pudding
Banana-Pecan-Breakfast-Bread-Food_com-163649	Banana Pecan Breakfast Bread
Banana-Pecan-Coconut-Muffins-or-Bread-Food_com-143226	Banana Pecan Coconut Muffins or Bread
Banana-Pineapple-Cashew-Bread-Recipezaar	Banana Pineapple Cashew Bread
Banana-Pineapple-Nut-Bread-Recipezaar	Banana Pineapple Nut Bread
Banana-Plum-Bread-AllRecipes-40144	Banana Plum Bread
Banana-Poppy-Seed-Quick-Bread-Recipezaar	Banana Poppy Seed Quick Bread
Banana-Pudding-Banana-Nut-Bread-Recipezaar	Banana Pudding Banana Nut Bread
Banana-Pudding-Bread-Recipezaar	Banana Pudding Bread
Banana-Pudding-Nut-Bread-Recipezaar	Banana Pudding Nut Bread
Banana-Pumpkin-Bread-Allrecipes	Banana Pumpkin Bread
Banana-Pumpkin-Bread-Recipezaar	Banana Pumpkin Bread
Banana-Pumpkin-Bread-with-Brown-Sugar-Icing-Food_com-128987	Banana-Pumpkin Bread with Brown Sugar Icing
Banana-Pumpkin-Bread-With-Orange-Cream-Cheese-Spread-Food_com-165272	Banana Pumpkin Bread With Orange Cream Cheese Spread
Banana-Pumpkin-Zucchini-Bread-Recipezaar	Banana Pumpkin Zucchini Bread
Banana-Raisin-Bread-Pudding-Martha-Stewart-191069	Banana-Raisin Bread Pudding
Banana-Raisin-Bread-Recipezaar	Banana Raisin Bread
Banana-Raisin-Bread-Recipezaar_1	Banana Raisin Bread
Banana-Raisin-Peanut-Bread-Recipezaar	Banana Raisin Peanut Bread
Banana-Raspberry-Bread-Recipezaar	Banana Raspberry Bread
Banana-Rice-Bread-_liberia_-Recipezaar	Banana Rice Bread (Liberia)
Banana-Salsa-Bread-Recipezaar	Banana Salsa Bread
Banana-Soda-Bread-Recipezaar	Banana Soda Bread
Banana-Sour-Cream-Bread-Allrecipes	Banana Sour Cream Bread
Banana-Sour-Cream-Bread-Food_com-84055	Banana Sour Cream Bread
Banana-Sour-Cream-Bread-Recipezaar	Banana Sour Cream Bread
Banana-Sour-Cream-Nut-Bread-With-Glaze-Food_com-171088	Banana Sour Cream Nut Bread With Glaze
Banana-Split-Bread-Food_com-106257	Banana Split Bread
Banana-Split-Bread-Food_com-131456	Banana Split Bread
Banana-Split-Bread-Food_com-151910	Banana Split Bread
Banana-Split-Bread-Food_com-87205	Banana Split Bread
Banana-Split-Bread-Recipezaar_2	Banana Split Bread
Banana-Split-Bread-Recipezaar_3	Banana Split Bread
Banana-Split-Bread-TasteOfHome	Banana Split Bread
Banana-Split-Bread-TasteOfHome_1	Banana Split Bread
Banana-Strawberry-Bread-Recipezaar	Banana Strawberry Bread
Banana-Streusel-Bread-Recipezaar	Banana Streusel Bread
Banana-Tea-Bread-Food_com-149132	Banana Tea Bread
Banana-Tea-Bread-From-The-New-York-Times-Recipezaar	Banana Tea Bread from the New York Times
Banana-Tea-Bread-Recipe-Recipezaar	Banana Tea Bread Recipe
Banana-Tea-Bread-Recipezaar	Banana Tea Bread
Banana-Tea-Bread-Recipezaar_1	Banana Tea Bread
Banana-Tea-Bread-Recipezaar_2	Banana Tea Bread
Banana-Tea-Bread-Recipezaar_3	Banana Tea Bread
Banana-Toffee-Bread-Pudding-Food_com-188649	Banana Toffee Bread Pudding
Banana-Walnut-Bread-Food_com-156013	Banana Walnut Bread
Banana-Walnut-Bread-MyRecipes-205818	Banana Walnut Bread
Banana-Walnut-Bread-Pudding-With-Buttery-Rum-Sauce-Food-Network	Banana Walnut Bread Pudding with Buttery Rum Sauce
Banana-Walnut-Bread-Pudding_Buttery-Rum-Sauce-Food_com-130398	Banana Walnut Bread Pudding/Buttery Rum Sauce
Banana-Walnut-Bread-Recipezaar	Banana Walnut Bread
Banana-Walnut-Bread-Recipezaar_1	Banana Walnut Bread
Banana-Walnut-Bread-Recipezaar_2	Banana Walnut Bread
Banana-Walnut-Bread-Recipezaar_3	Banana Walnut Bread
Banana-Walnut-Bread-Recipezaar_4	Banana Walnut Bread
Banana-Walnut-Bread-_splenda_-Recipezaar	Banana Walnut Bread (Splenda)
Banana-walnut-bread-_sugar_grain_gluten-free_-301747	Banana Walnut Bread (Sugar/Grain/Gluten Free)
Banana-Walnut-Buttermilk-Bread-Recipezaar	Banana Walnut Buttermilk Bread
Banana-Walnut-Loaf-_bread-Machine_-Recipezaar	Banana Walnut Loaf (Bread Machine)
Banana-Wheat-Bread-Allrecipes	Banana Wheat Bread
Banana-Wheat-Bread-_bread-Machine_-Recipezaar	Banana Wheat Bread (Bread Machine)
Banana-Whole-Wheat-Bread-Recipezaar	Banana Whole Wheat Bread
Banana-Yogurt-Bread-MyRecipes-205882	Banana Yogurt Bread
Banana-Yogurt-Bread-Recipezaar	Banana Yogurt Bread
Banana-Zucchini-Applesauce-Bread-Food_com-63473	Banana Zucchini Applesauce Bread
Banana-Zucchini-Bread-Recipezaar	Banana Zucchini Bread
Banana-Zucchini-Bread-Recipezaar_1	Banana Zucchini Bread
Banana-Zucchini-Spelt-Bread-With-Rainier-Cherries-Recipezaar	Banana Zucchini Spelt Bread With Rainier Cherries
Banana-_-Applesauce-_-Blueberry-And-Walnut-Fat_free-Quick-Bread-Recipezaar	Banana - Applesauce - Blueberry and Walnut Fat-Free Quick Bread
Banana-_-Pumpkin-Bread-_-Nuwave-Oven-Recipezaar	Banana / Pumpkin Bread - Nuwave Oven
Banana-_-Raspberry-Bread-Low-Fat-Recipezaar	Banana - Raspberry Bread Low Fat
Bananaberry-Bread-Recipezaar	bananaberry bread
Bananacran-Bread-Recipezaar	Bananacran Bread
Bananaey-Banana-Bread-Recipezaar	Bananaey Banana Bread
Bananas-and-Cream-Bread-_For-Bread-Machines_-Food_com-72304	Bananas and Cream Bread (For Bread Machines)
Bananas-Foster-Bread-Food_com-178372	Bananas Foster Bread
Bananas-Foster-Bread-MyRecipes-244196	Bananas Foster Bread
Bananas-Foster-Bread-Pudding-Food_com-143833	Bananas Foster Bread Pudding
Bananas-Foster-Bread-Pudding-My-Recipes	Bananas Foster Bread Pudding
Bananas-Foster-Bread-Pudding-Recipezaar	Bananas Foster Bread Pudding
Bananas-Foster-Bread-Pudding-Recipezaar_2	Bananas Foster Bread Pudding
Bananas-Foster-Bread-Pudding-With-Vanilla-Ice-Cream-And-Caramel-Sauce-Food-Network	Bananas Foster Bread Pudding with Vanilla Ice Cream and Caramel Sauce
Bananas-Foster-Bread-Recipezaar	Bananas Foster Bread
Bananas-Foster-Monkey-Bread-AllRecipes	Bananas Foster Monkey Bread
Banana_-Chocolate-Chip_-Raisin-Bread-_-Food_com-154685	Banana, Chocolate Chip, Raisin Bread :)
Banana_-Coconut-Lime-Bread-Food_com-178567	Banana, Coconut Lime Bread
Banana_-Zucchini-or-Apple-Bread-Food_com-181150	Banana, Zucchini or Apple Bread
Banana_apricot-Bread-My-Recipes	Banana-Apricot Bread
Banana_apricot-Walnut-Bread-Recipezaar	Banana-Apricot Walnut Bread
Banana_berry-Nut-Bread-TasteOfHome	Banana-Berry Nut Bread
Banana_blueberry-Bread-Machine-Bread-Recipezaar	Banana-Blueberry Bread Machine Bread
Banana_caramel-Bread-Pudding-My-Recipes	Banana-Caramel Bread Pudding
Banana_chocolate-Caramel-Bread-Pudding-Recipezaar	Banana-Chocolate Caramel Bread Pudding
Banana_coconut-Bread-Recipezaar	Banana-Coconut Bread
Banana_date-Flax-Seed-Bread-Recipezaar	Banana-Date Flax Seed Bread
Banana_date-Flaxseed-Bread-My-Recipes	Banana-Date Flaxseed Bread
Banana_gingerbread-Muffins-Recipezaar	Banana-gingerbread Muffins
Banana_lemon-Tea-Bread-Recipezaar	Banana-Lemon Tea Bread
Banana_nut-Bread-Epicurious	Banana-Nut Bread
Banana_nut-Bread-Epicurious_1	Banana-Nut Bread
Banana_nut-Bread-My-Recipes	Banana-nut Bread
Banana_nut-Bread-My-Recipes_1	Banana-Nut Bread
Banana_nut-Bread-My-Recipes_2	Banana-Nut Bread
Banana_nut-Bread-Recipezaar	Banana-Nut Bread
Banana_nut-Bread-Recipezaar_1	Banana-Nut Bread
Banana_nut-Chip-Bread-TasteOfHome	Banana-Nut Chip Bread
Banana_nut-Corn-Bread-TasteOfHome	Banana-Nut Corn Bread
Banana_oat-Quick-Bread-My-Recipes	Banana-Oat Quick Bread
Banana_oatmeal-Bread-My-Recipes	Banana-Oatmeal Bread
Banana_oatmeal-Bread-Recipezaar	Banana-Oatmeal Bread
Banana_oatmeal-Bread-Recipezaar_1	Banana-Oatmeal Bread
Banana_oatmeal-Bread-Recipezaar_2	Banana-Oatmeal Bread
Banana_Orange-Bread-Food_com-144451	Banana/Orange Bread
Banana_pecan-Bread-Recipezaar	Banana-Pecan Bread
Banana_pineapple-Nut-Bread-_healthy_-Recipezaar	Banana-Pineapple Nut Bread (Healthy)
Banana_pumpkin-Bread-Recipezaar	Banana-Pumpkin Bread
Banana_raisin-Oat-Bread-Recipezaar	Banana-Raisin Oat Bread
Banana_raisin-Whole-Wheat-Bread-Recipezaar	Banana-Raisin Whole Wheat Bread
Banana_raisin-Whole-Wheat-Bread_-No_egg_-No_oil-Recipezaar	Banana-Raisin Whole Wheat Bread, No-Egg, No-Oil
Banana_raspberry-Bread-Epicurious	Banana-Raspberry Bread
Banana_walnut-Bread-Recipezaar	Banana-Walnut Bread
Banana_zucchini-Bread-Allrecipes	Banana-Zucchini Bread
Banging-Banana-Bread-Food_com-114963	Banging Banana Bread
Bangin_-Banana-Bread-AllRecipes	Bangin' Banana Bread
Barb_s-Banana-Nut-Bread-MyRecipes-242769	Barb's Banana Nut Bread
Barkin-Banana-Bread-For-Dogs-Recipezaar	Barkin Banana Bread for Dogs
Basic-Banana-Bread-Food_com-134205	Basic Banana Bread
Basic-Banana-Bread-MyRecipes-244181	Basic Banana Bread
Bates-Banana-Bread-AllRecipes-202910	Bates Banana Bread
Beautiful-Banana-Bread-Food_com-145840	Beautiful Banana Bread
Bea_s-Banana-Bread-Food_com-83585	Bea's Banana Bread
Bee_sweet-Banana-Bread-Recipezaar	Bee-Sweet Banana Bread
Beloved-Banana-Bread-Recipezaar	Beloved Banana Bread
Berry-Banana-Bread-Recipezaar	Berry Banana Bread
Berry-Banana-Bread-_pampered-Chef_-Recipezaar	Berry Banana Bread (Pampered Chef)
Berry-Banana-Walnut-Bread-MyRecipes-243361	Berry-Banana Walnut Bread
Best-Banana-Bread---No-Egg_-No-Milk_-Gluten-Free-Food_com-147105	Best Banana Bread - No Egg, No Milk, Gluten Free
Best-Banana-Bread-Ever-Ever-Ever_-Recipezaar	Best Banana Bread Ever Ever Ever!
Best-Banana-Bread-Ever-Food_com-133256	Best Banana Bread Ever
Best-Banana-Bread-Ever-Recipezaar	Best Banana Bread Ever
Best-Banana-Bread-Ever-Recipezaar_1	Best Banana Bread Ever
Best-Banana-Bread-Ever_-Seriously_-Food_com-135995	Best Banana Bread Ever, Seriously!
Best-Banana-Bread-Food_com-70294	Best Banana Bread
Best-Banana-Bread-Food_com-87714	Best Banana Bread
Best-Banana-Bread-Or-Muffins-Recipezaar	Best Banana Bread Or Muffins
Best-Banana-Bread-Recipe-Chow-57542	Best Banana Bread Recipe
Best-Banana-Bread-Recipe-Recipezaar	Best Banana Bread Recipe
Best-Banana-Bread-Recipezaar	Best Banana Bread
Best-Banana-Bread-Recipezaar_1	Best Banana Bread
Best-Banana-Bread-Recipezaar_2	Best Banana Bread
Best-Banana-Bread-Recipezaar_3	Best Banana Bread
Best-Banana-Bread-Recipezaar_4	Best Banana Bread
Best-Banana-Bread-Recipezaar_5	Best Banana Bread
Best-Banana-Bread-Recipezaar_6	Best Banana Bread
Best-Banana-Bread-Recipezaar_7	Best Banana Bread
Best-Banana-Bread-Recipezaar_8	Best Banana Bread
Best-Banana-Bread_-Gluten-Free-Food_com-175613	Best Banana Bread, Gluten-Free
Best-Banana-Bread_-Recipezaar	Best Banana Bread!
Best-Banana-Nut-Bread-Recipezaar	Best Banana Nut Bread
Best-Banana_oat-Bread-Recipezaar	Best Banana-Oat Bread
Best-Ever-Banana-Bread-Allrecipes	Best Ever Banana Bread
Best-Ever-Banana-Bread-Food_com-66161	Best Ever Banana Bread
Best-Ever-Banana-Bread-Recipezaar	Best Ever Banana Bread
Best-Ever-Banana-Bread-Recipezaar_1	Best Ever Banana Bread
Best-Ever-Banana-Bread-Recipezaar_2	Best Ever Banana Bread
Best-Ever-Banana-Bread-Recipezaar_3	Best Ever Banana Bread
Best-Ever-Banana-Bread-_honestly_-Food_com-190092	Best-Ever Banana Bread (honestly!)
Best-Ever-Sour-Cream-Banana-Bread-Recipezaar	Best Ever Sour Cream Banana Bread
Best-Gluten-_Dairy_-Egg-Free-Banana-Bread-Food_com-83454	Best Gluten /Dairy/ Egg Free Banana Bread
Best-Healthy-Banana-Bread-Recipezaar	Best Healthy Banana Bread
Best-Low-Fat-Banana-Bread-Food_com-164426	Best Low Fat Banana Bread
Best-Of-Kansas-Banana_walnut-Bread-Recipezaar	Best of Kansas Banana-Walnut  Bread
Best-Vegan-Banana-Bread-Recipezaar	Best Vegan Banana Bread
Best-_-Easiest-Banana-Bread-Recipezaar	Best & Easiest Banana Bread
Bestest-Ever-Banana-Bread-Recipezaar	Bestest Ever Banana Bread
Best_ever-Banana-Bread-Recipezaar	Best-Ever Banana Bread
Best_ever-Banana-Bread-Recipezaar_1	Best-Ever Banana Bread
Best_ever-Banana-Bread-Recipezaar_2	Best-Ever Banana Bread
Bet-On-It-Banana-Bread-By-Marjie-Lapagna-Recipezaar	Bet on It Banana Bread by Marjie Lapagna
Better-Banana-Bread-Recipezaar	Better Banana Bread
Better-Banana-Walnut-Bread-Food_com-83441	Better Banana Walnut Bread
Better-Homes-and-Gardens-Banana-Bread-Food_com-94986	Better Homes and Gardens Banana Bread
Better-Than-Banana-Bread-Recipezaar	Better Than Banana Bread
Better-Than-Grandma_s-Banana-Bread-Recipezaar	Better Than Grandma's Banana Bread
Betty-Crocker-Blueberry-Banana-Bread-Food_com-162969	Betty Crocker Blueberry Banana Bread
Betty-Crockers-Banana-Bread-Recipezaar	Betty Crockers Banana Bread
Betty-Crocker_s-Banana-Bread-Recipezaar	Betty Crocker's Banana Bread
Bettye_s-Best-Banana-Bread-Food_com-155692	Bettye's Best Banana Bread
Big-Bird-Banana-Bread-Recipezaar	Big Bird Banana Bread
Big-Moist-Banana-Bread-Recipezaar	Big Moist Banana Bread
Bisquick-Banana-Bread-Recipezaar	Bisquick Banana Bread
Bisquick-Banana_craisin-Bread-Recipezaar	Bisquick Banana-Craisin Bread
Black-Bottom-Banana-Bread-Recipezaar	Black Bottom Banana Bread
Black-Walnut-Banana-Nut-Bread-Recipezaar	Black Walnut Banana Nut Bread
Blender-Banana-Bread-Recipezaar	Blender Banana Bread
Blueberry-Banana-Bread-Food-Network	Blueberry Banana Bread
Blueberry-Banana-Bread-My-Recipes	Blueberry Banana Bread
Blueberry-Banana-Bread-Or-Muffins-Recipezaar	Blueberry Banana Bread or Muffins
Blueberry-Banana-Bread-Recipe-Chow-56867	Blueberry Banana Bread Recipe
Blueberry-Banana-Bread-Recipezaar	Blueberry Banana Bread
Blueberry-Banana-Bread-Recipezaar_1	Blueberry Banana Bread
Blueberry-Banana-Bread-Recipezaar_2	Blueberry Banana Bread
Blueberry-Banana-Bread-Recipezaar_3	Blueberry Banana Bread
Blueberry-Banana-Bread-Recipezaar_4	Blueberry Banana Bread
Blueberry-Banana-Bread-Recipezaar_5	Blueberry Banana Bread
Blueberry-Banana-Bread-Recipezaar_6	Blueberry Banana Bread
Blueberry-Banana-Bread-Recipezaar_7	Blueberry Banana Bread
Blueberry-Banana-Bread-TasteOfHome	Blueberry Banana Bread
Blueberry-Banana-Bread-_lower-Fat_-Recipezaar	Blueberry Banana Bread (Lower Fat)
Blueberry-Banana-Nut-Oatmeal-Bread-Recipezaar	Blueberry Banana Nut Oatmeal Bread
Blueberry-Lemon-Banana-Bread-with-Cream-Cheese-Glaze-MyRecipes-267567	Blueberry-Lemon Banana Bread with Cream-Cheese Glaze
Blueberry-Upside_Down-Banana-Nut-Bread-AllRecipes	Blueberry Upside-Down Banana Nut Bread
Blueberry-_-Banana-Bread-Recipezaar	Blueberry & Banana Bread
Blueberry_-Zucchini-and-Banana-Bread-Food_com-182003	Blueberry, Zucchini and Banana Bread
Blueberry_banana-Bread-My-Recipes	Blueberry-Banana Bread
Blueberry_banana_oat-Bread-Food-Network	Blueberry-Banana-Oat Bread
Blueberry_banana_oat-Bread-Recipezaar	Blueberry-Banana-Oat Bread
Bobra_s-Banana-Bread-AllRecipes-36913	Bobra's Banana Bread
Bob_s-Red-Mill-Easy-Gluten-Free-Banana-Bread-Recipezaar	Bob's Red Mill Easy Gluten Free Banana Bread
Bob_s-Tasty-Banana-Bread-Recipezaar	Bob's Tasty Banana Bread
Bonnie_s-Best-Banana-Bread-_-Bonnie-Stern-Recipezaar	Bonnie's Best Banana Bread - Bonnie Stern
Boy-Or-Girl-Banana-Bread-Recipezaar	Boy or Girl Banana Bread
Braided-Banana-Date-Nut-Bread-_ABM_-Food_com-163266	Braided Banana Date Nut Bread (ABM)
Bread-Machine-Banana-Nut-Bread-Yeast-1-Lb-Food_com-97457	Bread Machine Banana Nut Bread Yeast 1 Lb
Bread-Machine-Banana-Oatmeal-Bread-Recipezaar	Bread Machine Banana Oatmeal Bread
Bread-Machine-Peanut-Butter-_-Banana-Bread-Recipezaar	Bread Machine Peanut Butter & Banana Bread
Bread-Maker-Banana-Oat-Bread-Recipezaar	Bread Maker Banana Oat Bread
Breakfast-Banana-Bread-Pudding-Food_com-132434	Breakfast Banana Bread Pudding
Breakfast-Banana_nut-Bread-Recipezaar	Breakfast Banana-Nut Bread
Briggi_s-Astounding-Banana-Bread-Food_com-140760	Briggi's Astounding Banana Bread
Brown-Butter-Banana-Bread-Food_com-151513	Brown Butter Banana Bread
Brown-Butter-Banana-Bread-Food_com-153855	Brown Butter Banana Bread
Brown-Sugar-Banana-Bread-AllRecipes-39219	Brown Sugar Banana Bread
Brown-Sugar-Banana-Bread-Recipe-Chow-48219	Brown Sugar Banana Bread Recipe
Brown-Sugar-Banana-Bread-Recipezaar	Brown Sugar Banana Bread
Brown-Sugar-Banana-Nut-Bread-I-Allrecipes	Brown Sugar Banana Nut Bread I
Brown-Sugar-Banana-Nut-Bread-Ii-Allrecipes	Brown Sugar Banana Nut Bread II
Buckwheat_yogurt-Banana-Bread-_guilt_free_-Recipezaar	Buckwheat-Yogurt Banana Bread (Guilt-Free)
Bunches-Of-Bananas-Bread-Recipezaar	Bunches of Bananas Bread
Buttermilk-Banana-Bread-Food_com-162695	Buttermilk Banana Bread
Buttermilk-Banana-Bread-Food_com-181960	Buttermilk Banana Bread
Buttermilk-Banana-Bread-Recipezaar	Buttermilk Banana Bread
Buttermilk-Banana-Bread-Recipezaar_1	Buttermilk Banana Bread
Buttermilk-Banana-Bread-Recipezaar_2	Buttermilk Banana Bread
Butterscotch-Banana-Bread-Recipezaar	Butterscotch Banana Bread
Butterscotch-Banana-Bread-Waffles-Recipezaar	Butterscotch Banana Bread Waffles
Buttery-Banana-Bread-Food_com-292910	Buttery Banana Bread
Buttery-Banana-Nut-Bread-Recipezaar	Buttery Banana Nut Bread
Cake-Mix-Banana-Bread-Recipezaar	Cake Mix Banana Bread
Cake-Mix-Banana-Bread-Recipezaar_1	Cake Mix Banana Bread
Caramel-Banana-Bourbon-Bread-Pudding-Recipezaar	Caramel Banana Bourbon Bread Pudding
Caramel-Macchiato-Banana-Bread-AllRecipes-39674	Caramel Macchiato Banana Bread
Caramelized-Banana-Raisin-Bread-Pudding-Recipezaar	Caramelized Banana Raisin Bread Pudding
Caramelized-Banana-Rum-Bread-Pudding-_-Chocolate-Rum-Sauce-Food_com-68566	Caramelized Banana Rum Bread Pudding &amp; Chocolate Rum Sauce
Caramel_banana-Bread-Puddings-Epicurious	Caramel-Banana Bread Puddings
Cardamom-Banana-Bread-Allrecipes	Cardamom Banana Bread
Cardamom-Banana-Bread-Recipezaar	Cardamom Banana Bread
Cardamom-Banana-Bread-With-Pistachios-My-Recipes	Cardamom Banana Bread with Pistachios
Cardamom-Banana-Bread-With-Pistachios-Recipezaar	Cardamom Banana Bread With Pistachios
Caribbean-Banana-Lime-Bread-Food_com-76393	Caribbean Banana Lime Bread
Caribbean-Coconut-_banana_-Bread-Recipezaar	Caribbean Coconut (Banana) Bread
Carole_s-Banana-Bread-Supreme-Food_com-176534	Carole's Banana Bread Supreme
Carrot-Banana-Bread-Recipezaar	Carrot Banana Bread
Carrot-Banana-Bread-TasteOfHome	Carrot Banana Bread
Carrot_-Banana-and-Ginger--Bread-_Gluten-Free_-Food_com-152088	Carrot, Banana and Ginger  Bread (Gluten Free)
Carrot_banana-Oat-Bread-Recipezaar	Carrot-Banana Oat Bread
Cathy_s-Banana-Bread-Allrecipes	Cathy's Banana Bread
Chai-Banana-Bread-Food_com-179173	Chai Banana Bread
Chai-Banana-Bread-MyRecipes-281068	Chai Banana Bread
Chai-Spice-Banana-Bread-Food_com-112968	Chai-Spice Banana Bread
Chandler_s-Most-Awesome-Banana-Bread-Food_com-100051	Chandler's Most Awesome Banana Bread
Chef-Dine_s-Banana-Quick-Bread-Recipezaar	Chef Dine's Banana Quick Bread
Chelle_s-Banana-Bread-Recipezaar	Chelle's Banana Bread
Cherie_-S-Banana-Bread-Food_com-103973	Ch&eacute;rie' S Banana Bread
Cherry-Banana-Bread-Recipezaar	Cherry Banana Bread
Cheryl_s-Wanted-To-Use-Up-6-Ripe-Bananas-Banana-Bread-Recipezaar	Cheryl's Wanted to Use up 6 Ripe Bananas Banana Bread
Chewy-Banana-Oatmeal-Bread-_a_b_m_-Recipezaar	Chewy Banana Oatmeal Bread (A*b*m)
Choc-Banana-Bread-Recipezaar	Choc Banana Bread
Chocolate-Banana-Bread-Allrecipes	Chocolate Banana Bread
Chocolate-Banana-Bread-Allrecipes_1	Chocolate Banana Bread
Chocolate-Banana-Bread-Food_com-73006	Chocolate-Banana Bread
Chocolate-Banana-Bread-Food_com-74775	Chocolate Banana Bread
Chocolate-Banana-Bread-My-Recipes	Chocolate Banana Bread
Chocolate-Banana-Bread-MyRecipes-214531	Chocolate Banana Bread
Chocolate-Banana-Bread-Once-Upon-A-Chef-199944	Chocolate Banana Bread
Chocolate-Banana-Bread-Pudding-Allrecipes	Chocolate Banana Bread Pudding
Chocolate-Banana-Bread-Pudding-Food_com-153955	Chocolate Banana Bread Pudding
Chocolate-Banana-Bread-Pudding-MyRecipes-204337	Chocolate-Banana Bread Pudding
Chocolate-Banana-Bread-Pudding-Recipezaar	Chocolate Banana Bread Pudding
Chocolate-Banana-Bread-Pudding-Recipezaar_1	Chocolate Banana Bread Pudding
Chocolate-Banana-Bread-Pudding-With-Marshmallows-Food_com-112652	Chocolate Banana Bread Pudding With Marshmallows
Chocolate-Banana-Bread-Recipezaar	Chocolate Banana Bread
Chocolate-Banana-Bread-Recipezaar_1	Chocolate Banana Bread
Chocolate-Banana-Bread-Recipezaar_2	Chocolate Banana Bread
Chocolate-Banana-Bread-Recipezaar_3	Chocolate Banana Bread
Chocolate-Banana-Bread-Recipezaar_4	Chocolate Banana Bread
Chocolate-Banana-Bread-Recipezaar_5	Chocolate Banana Bread
Chocolate-Banana-Bread-Recipezaar_6	Chocolate Banana  Bread
Chocolate-Banana-Bread-Recipezaar_7	Chocolate Banana Bread
Chocolate-Banana-Bread-Recipezaar_8	Chocolate Banana Bread
Chocolate-Banana-Bread-Recipezaar_9	Chocolate Banana Bread
Chocolate-Banana-Bread-_low-Fat_-Recipezaar	Chocolate Banana Bread (Low Fat)
Chocolate-Banana-Cream-Bread-Recipezaar	Chocolate Banana Cream Bread
Chocolate-Banana-Mini-Breads-Recipezaar	Chocolate Banana Mini Breads
Chocolate-Bourbon-Spiked-Banana-Bread-Recipe-Leite_s-Culinaria-287065	Chocolate Bourbon-Spiked Banana Bread Recipe
Chocolate-Chip-and-Walnut-Banana-Bread-Muffins-Food_com-185097	Chocolate Chip and Walnut Banana Bread Muffins
Chocolate-chip-banana-bread-309038	Chocolate Chip Banana Bread
Chocolate-Chip-Banana-Bread-Food_com-152750	Chocolate Chip Banana Bread
Chocolate-Chip-Banana-Bread-Food_com-156329	Chocolate Chip Banana Bread
Chocolate-Chip-Banana-Bread-Food_com-177821	Chocolate Chip Banana Bread
Chocolate-Chip-Banana-Bread-Food_com-185177	Chocolate Chip Banana Bread
Chocolate-Chip-Banana-Bread-Food_com-287633	Chocolate Chip Banana Bread
Chocolate-Chip-Banana-Bread-Healthy-Style_-Food_com-104081	Chocolate Chip Banana Bread-Healthy Style!
Chocolate-Chip-Banana-Bread-I-Allrecipes	Chocolate Chip Banana Bread I
Chocolate-Chip-Banana-Bread-Ii-Allrecipes	Chocolate Chip Banana Bread II
Chocolate-Chip-Banana-Bread-Pudding-W_caramel-Sauce-Recipezaar	Chocolate Chip Banana Bread Pudding W/Caramel Sauce
Chocolate-Chip-Banana-Bread-Recipezaar	Chocolate Chip  Banana Bread
Chocolate-Chip-Banana-Bread-Recipezaar_1	Chocolate Chip Banana Bread
Chocolate-Chip-Banana-Bread-Recipezaar_2	Chocolate Chip Banana Bread
Chocolate-Chip-Banana-Bread-Recipezaar_3	Chocolate Chip Banana Bread
Chocolate-Chip-Banana-Bread-Recipezaar_4	Chocolate Chip Banana Bread
Chocolate-Chip-Banana-Bread-Recipezaar_5	Chocolate Chip Banana Bread
Chocolate-Chip-Banana-Bread-Recipezaar_6	Chocolate Chip Banana Bread
Chocolate-Chip-Banana-Bread-_low_fat_-Recipezaar	Chocolate Chip Banana Bread (Low-Fat)
Chocolate-Chip-Banana-Bread-_Soy_Dairy_Egg-Free-Edition_-Food_com-187347	Chocolate Chip Banana Bread (Soy/Dairy/Egg-Free Edition)
Chocolate-Chip-Banana-Nut-Bread-Recipezaar	Chocolate Chip Banana Nut Bread
Chocolate-Chip-Banana-Nut-Bread-Recipezaar_1	Chocolate Chip Banana Nut Bread
Chocolate-Chip-Coconut-Banana-Bread-Recipezaar	Chocolate Chip Coconut Banana Bread
Chocolate-Chip-Pecan-Banana-Bread-Recipezaar	Chocolate Chip Pecan Banana Bread
Chocolate-Chocolate-Banana-Bread-Food_com-129641	Chocolate Chocolate Banana Bread
Chocolate-Chocolate-Chip-Banana-Bread-Recipezaar	Chocolate Chocolate Chip Banana Bread
Chocolate-Chocolate-Chip-Sour-Cream-Banana-Bread-Recipezaar	Chocolate Chocolate Chip Sour Cream Banana Bread
Chocolate-Chunk-Banana-Bread-Recipezaar	Chocolate Chunk Banana Bread
Chocolate-Chunk_banana-Bread-Allrecipes	Chocolate Chunk-Banana Bread
Chocolate-Coconut-Banana-Nut-Bread-Recipezaar	Chocolate Coconut Banana Nut Bread
Chocolate-Peanut-Butter-Banana-Bread-MyRecipes-237900	Chocolate Peanut Butter Banana Bread
Chocolate-Peanut-Butter-Marbled-Banana-Bread-Food_com-143375	Chocolate Peanut Butter Marbled Banana Bread
Chocolate-Speckled-Banana-Bread-Food_com-113194	Chocolate Speckled Banana Bread
Chocolate-Zucchini-Banana-Bread-Recipezaar	Chocolate Zucchini Banana Bread
Chocolate_banana-Bread-Pudding-Recipezaar	Chocolate-Banana Bread Pudding
Chocolate_banana-Bread-Puddings-Recipezaar	Chocolate-Banana Bread Puddings
Chocolate_cherry-Banana-Bread-Recipezaar	Chocolate-Cherry Banana Bread
Chocolate_cherry-Banana-Bread-_diabetic-Friendly_-Recipezaar	Chocolate-Cherry Banana Bread  (Diabetic Friendly)
Chocolaty-Peanut-Butter-Banana-Bread-Recipezaar	Chocolaty Peanut Butter Banana Bread
Choco_chunky-Banana-Bread-Food-Network	Choco-Chunky Banana Bread
Christmas-Banana-Bread-Recipezaar	Christmas Banana Bread
Christmas-Banana-Bread-Recipezaar_1	Christmas Banana Bread
Christmas-Banana-Bread-TasteOfHome	Christmas Banana Bread
Chunky-Banana-Bread-With-Pecan-Streusel-Food_com-97794	Chunky Banana Bread With Pecan Streusel
Cinnamon-And-Whole-Wheat-Banana-Bread-Recipezaar	Cinnamon and Whole Wheat Banana Bread
Cinnamon-Banana-Bread-Recipezaar	Cinnamon Banana Bread
Cinnamon-Banana-Bread-Recipezaar_1	Cinnamon Banana Bread
Cinnamon-Banana-Bread-Recipezaar_2	Cinnamon Banana Bread
Cinnamon-Banana-Nut-Bread-Food_com-126224	Cinnamon Banana Nut Bread
Cinnamon-Chocolate-Chip-Banana-Bread-Food_com-186674	Cinnamon Chocolate Chip Banana Bread
Cinnamon-Crisp-Topped-Cream-Cheese-Banana-Nut-Bread-MyRecipes-228995	Cinnamon Crisp-Topped Cream Cheese-Banana-Nut Bread
Cinnamon-Pumpkin-Banana-Bread-Recipezaar	Cinnamon Pumpkin Banana Bread
Cinnamon-Sugar-Banana-Bread-Food_com-158874	Cinnamon Sugar Banana Bread
Cinnamon-Swirl-Banana-Bread-Food_com-67781	Cinnamon Swirl Banana Bread
Cinnamon-Topped-Banana-Bread-Food_com-80886	Cinnamon-Topped Banana Bread
Cinnamon_cream-Cheese_banana_nut-Bread-My-Recipes	Cinnamon-Cream Cheese-Banana-Nut Bread
Classic-Banana-Bread-AllRecipes	Classic Banana Bread
Classic-Banana-Bread-My-Recipes	Classic Banana Bread
Classic-Banana-Bread-Recipezaar	Classic Banana Bread
Classic-Banana-Bread-Recipezaar_1	Classic Banana Bread
Classic-Banana-Bread-With-Yogurt-Recipezaar	Classic Banana Bread With Yogurt
Classic-Banana-Nut-Bread-Recipezaar	Classic Banana Nut Bread
Close-As-It-Gets-Banana-Bread-Recipezaar	Close As It Gets Banana Bread
Coca-Cola-Banana-Bread-Recipezaar	Coca Cola Banana Bread
Coco-Loco-Banana-Daiquiri-Bread-Recipezaar	Coco Loco Banana Daiquiri Bread
Coconut-And-Macadamia-Nut-Banana-Bread-Epicurious	Coconut and Macadamia Nut Banana Bread
Coconut-And-Macadamia-Nut-Banana-Bread-Recipezaar	Coconut and Macadamia Nut Banana Bread
Coconut-And-Macadamia-Nut-Banana-Breads-Epicurious	Coconut and Macadamia Nut Banana Breads
Coconut-Banana-Bread-Recipezaar	Coconut Banana Bread
Coconut-Banana-Bread-Recipezaar_1	Coconut Banana Bread
Coconut-Banana-Bread-Recipezaar_2	Coconut Banana Bread
Coconut-Banana-Bread-TasteOfHome	Coconut Banana Bread
Coconut-Banana-Bread-With-Lime-Glaze-My-Recipes	Coconut Banana Bread with Lime Glaze
Coconut-Banana-Bread-With-Lime-Glaze-My-Recipes_1	Coconut Banana Bread with Lime Glaze
Coconut-Banana-Bread-With-Lime-Glaze-Recipezaar	Coconut Banana Bread With Lime Glaze
Coconut-Chocolate-Chip-Banana-Bread-Food_com-94368	Coconut Chocolate Chip Banana Bread
Coconut-Cream-Banana-Nut-Bread-Recipezaar	Coconut Cream Banana Nut Bread
Coconut_pineapple-Banana-Bread-Recipezaar	Coconut-Pineapple Banana Bread
Confetti-Banana-Bread-Recipezaar	Confetti Banana Bread
Cooking-Light-_toni_s_-Banana-Bread-Recipezaar	Cooking Light (Toni's) Banana Bread
Copycat-_bill_s_-Chocolate-Banana-Bread-Recipezaar	Copycat "Bill's" Chocolate Banana Bread
Country-Banana-Bread-Allrecipes	Country Banana Bread
Country-Girl_s-Banana_carrot_ginger-Bread-Recipezaar	Country Girl's Banana-Carrot-Ginger Bread
Crackly-banana-bread-305663	Crackly Banana Bread
Cranberry-Banana--Bread-Food_com-89779	Cranberry Banana  Bread
Cranberry-Banana-Bread-Food_com-125713	Cranberry Banana Bread
Cranberry-Banana-Bread-Food_com-153344	Cranberry Banana Bread
Cranberry-Banana-Bread-Recipe-Taste-of-Home-44718	Cranberry Banana Bread Recipe
Cranberry-Banana-Bread-Recipezaar	Cranberry Banana Bread
Cranberry-Banana-Nut-Bread-Recipezaar	Cranberry Banana Nut Bread
Cranberry-Banana-Nut-Bread-Recipezaar_1	Cranberry Banana Nut Bread
Cranberry-Banana-Oat-Bread-AllRecipes-37055	Cranberry Banana Oat Bread
Cranberry-Banana-Oat-Bread-Food_com-108206	Cranberry Banana Oat Bread
Cranberry-Pumpkin-Banana-Bread-AllRecipes	Cranberry Pumpkin Banana Bread
Cranberry_banana-Bread-Recipezaar	Cranberry-Banana Bread
Cranberry_walnut-Banana-Bread-Recipezaar	Cranberry-Walnut Banana Bread
Cranky-Banana-Bread-Recipezaar	Cranky Banana Bread
Crater-Banana-Bread-Recipezaar	Crater Banana Bread
Cream-Cheese-Banana-Bread-_Moist_-Food_com-287438	Cream Cheese Banana Bread (Moist)
Cream-Cheese-Banana-Nut-Bread-Food_com-168161	Cream Cheese-Banana-Nut Bread
Cream-Cheese-Banana-Nut-Bread-Recipezaar	Cream Cheese Banana Nut Bread
Cream-Cheese-Banana_cranberry-Bread-Recipezaar	Cream Cheese Banana-Cranberry Bread
Cream-Cheese-Banana_nut-Bread-Recipezaar	Cream Cheese Banana-Nut Bread
Cream-Cheese-Walnut-Banana-Bread-Recipezaar	Cream Cheese Walnut Banana Bread
Cream-Cheese_banana_nut-Bread-My-Recipes	Cream Cheese-Banana-Nut Bread
Cream-Cheese_banana_nut-Bread-My-Recipes_1	Cream Cheese-Banana-Nut Bread
Cream-Cheese_banana_nut-Bread-Recipezaar	Cream Cheese-Banana-Nut Bread
Creamy-Banana-Bread-Allrecipes	Creamy Banana Bread
Creamy-Banana-Bread-Food_com-95352	Creamy Banana Bread
Creamy-Banana-Bread-Recipezaar	Creamy Banana Bread
Creole-Banana-Bread-Puddings-With-Caramel-Sauce-My-Recipes	Creole Banana Bread Puddings with Caramel Sauce
Creole-Banana-Bread-Puddings-With-Caramel-Sauce-Recipezaar	Creole Banana Bread Puddings With Caramel Sauce
Crispy-Cinnamon-Streusel-Banana-Nut-Cream-Cheese-Bread-Food_com-130686	Crispy Cinnamon Streusel Banana Nut Cream Cheese Bread
Crock-Pot-Banana-Bread-Recipezaar	Crock Pot Banana Bread
Crock-Pot-Banana-Bread-Recipezaar_1	Crock Pot Banana Bread
Crumb-Topped-Cocoa-Banana-Bread-Food_com-155246	Crumb-Topped Cocoa Banana Bread
Crunchy-Banana-Colada-Bread-Recipezaar	Crunchy Banana Colada Bread
Crunchy-Mixed-Grain-Banana-Bread-Recipezaar	Crunchy Mixed Grain Banana Bread
Dad_s-Banana-Bread-Recipezaar	Dad's Banana Bread
Dad_s-Banana-Nut-Bread-AllRecipes-201819	Dad's Banana Nut Bread
Dad_s-Famous-Banana-Bread-Food_com-168454	Dad's Famous Banana Bread
dairy-free-whole-grain-banana-bread-Recipe-Chow-48486	dairy free whole grain banana bread Recipe
Dairy-Lactose-Free-Banana-Nut-Loaf-Bread-Food_com-176536	Dairy Lactose Free Banana Nut Loaf Bread
Danish-Banana-Bread-Recipezaar	Danish Banana Bread
Dark-Chocolate-Pecan-Banana-Bread-Food_com-99859	Dark Chocolate Pecan Banana Bread
Deb_s-Banana-Bread-Recipezaar	Deb's Banana Bread
Dee_s-Chocolate-Banana-Bread-Recipezaar	Dee's Chocolate Banana Bread
Del-Monte-Banana-Bread-Food_com-183767	Del Monte Banana Bread
Delicious-And-Easy-Banana-Bread-Or-Muffins-Recipezaar	Delicious and Easy Banana Bread or Muffins
Delicious-Banana-Bread-Recipe-Food_com-163773	Delicious Banana Bread Recipe
Delicious-Banana-Bread-Recipe-Food_com-167782	Delicious Banana Bread Recipe
Delicious-Banana-Bread-Recipezaar	Delicious Banana Bread
Delicious-Banana-Bread-Recipezaar_1	Delicious Banana Bread
Delicious-Banana-Bread-_-_-Recipezaar	Delicious Banana Bread : )
Delicious-Healthy-Banana-Bread-Food_com-175645	Delicious Healthy Banana Bread
Delicious-Low-Fat-Banana-Bread-With-Chocolate-Chips-Recipezaar	Delicious Low Fat Banana Bread With Chocolate Chips
Delicious-Low-Sugar-Banana-Bread-Recipezaar	Delicious Low Sugar  Banana Bread
Delicious-Nutritious-Banana-Bread-Recipezaar	Delicious Nutritious Banana Bread
Delicious-Raisin-Nut-Banana-Bread-Allrecipes	Delicious Raisin Nut Banana Bread
Delicious-Raisin-Nut-Banana-Bread-Allrecipes_1	Delicious Raisin Nut Banana Bread
Delicious-Sour-Cream_Banana-Bread-AllRecipes	Delicious Sour Cream-Banana Bread
Delicious-Whole-Wheat-Banana-Bread-Recipezaar	Delicious Whole Wheat Banana Bread
Deliciously-Simple-Banana-Bread-Food_com-97766	Deliciously Simple Banana Bread
Diabetic-Banana-Bread-For-Bread-Machine-Recipezaar	Diabetic Banana Bread for Bread Machine
Diabetic-Banana-Bread-Recipezaar	Diabetic Banana Bread
Dick_s-Wheaties-Flake-Banana-Bread-Recipezaar	Dick's Wheaties Flake Banana Bread
Dole_s-Banana-Bread-Recipezaar	Dole's Banana Bread
Dora-Benston_s-Pioneer-Banana-Bread-Recipezaar	Dora Benston's Pioneer Banana Bread
Dorothy_s-Banana-Nut-Bread-Recipezaar	Dorothy's Banana Nut Bread
Double-Banana-Bread-Food_com-69548	Double Banana Bread
Double-Banana-Bread-Recipezaar	Double Banana Bread
Double-Chocolate-Banana-Bread-Recipezaar	Double Chocolate Banana Bread
Double-Chocolate-Banana-Bread-Recipezaar_1	Double Chocolate Banana Bread
Down-Home-Banana-Bread-Pudding-Recipezaar	Down Home Banana Bread Pudding
Dried-Blueberry_-Cranberry-Or-Apricot-Banana-Nut-Bread-Recipezaar	Dried Blueberry, Cranberry or Apricot Banana Nut Bread
Dr_-Weil_s-Banana-Bread-Recipezaar	Dr. Weil's Banana Bread
Easiest-Ever-Banana-Bread-Recipezaar	Easiest Ever Banana Bread
Easy-Banana-Bread-Food_com-139066	Easy Banana Bread
Easy-Banana-Bread-Food_com-185060	Easy Banana Bread
Easy-Banana-Bread-Food_com-217997	Easy Banana Bread
Easy-Banana-Bread-Recipezaar	Easy Banana Bread
Easy-Banana-Bread-Recipezaar_1	Easy Banana Bread
Easy-Banana-Bread-Recipezaar_2	Easy Banana Bread
Easy-Banana-Bread-Recipezaar_3	Easy Banana Bread
Easy-Banana-Bread-Recipezaar_4	Easy Banana Bread
Easy-Banana-Bread-Recipezaar_5	Easy Banana Bread
Easy-Banana-Bread-Recipezaar_6	Easy Banana Bread
Easy-Banana-Bread-_-Chocolate-Nut-Recipezaar	Easy Banana Bread - Chocolate Nut
Easy-Banana-Nut-Bread-Recipezaar	Easy Banana Nut Bread
Easy-Banana-Nut-Bread-Recipezaar_1	Easy Banana Nut Bread
Easy-Best-Ever-Banana-Bread-Food_com-121461	Easy Best Ever Banana Bread
Easy-Delicious-Banana-Bread-Food_com-69972	Easy Delicious Banana Bread
Easy-Homestyle-Banana-Bread-Recipezaar	Easy Homestyle Banana Bread
Easy-Lower-Sugar-Banana-Flax-Bread-Food_com-280149	Easy Lower Sugar Banana Flax Bread
Easy-Peasy-Banana-Nut-Bread-Food_com-178735	Easy Peasy Banana Nut Bread
Easy-Sour-Cream-Banana-Bread-Recipezaar	Easy Sour Cream Banana Bread
Easy-_-Tasty-Banana-Bread-Recipezaar	Easy &amp; Tasty Banana Bread
Eating-Suburbia_s-5-Minutes-3-Bananas-Banana-Bread-Food_com-113775	Eating Suburbia's 5 Minutes 3 Bananas Banana Bread
Edible-Candles-_-Decoration-For-Banana-Bread_-Banofee-Cheesecake-Recipezaar	Edible Candles (Decoration for Banana Bread, Banoffee Cheesecake
Egg-Free-Banana-Bread-Food_com-105009	Egg-Free Banana Bread
Eggless-Banana-Bread-Recipezaar	Eggless Banana Bread
Eggless-Banana-Bread-Recipezaar_1	Eggless Banana Bread
Eggless-Caribbean-Banana-Bread-Recipezaar	Eggless Caribbean Banana Bread
Eggless-Coffee-Banana-Bread-Food_com-137528	Eggless Coffee Banana Bread
Eggless-Cranberry-Orange-Banana-Bread-Recipezaar	Eggless Cranberry Orange Banana Bread
Eggnog-Banana-Bread-Food_com-130435	Eggnog Banana Bread
Egg_free-Chocolate-Chip-Banana-Bread-Recipezaar	Egg-Free Chocolate Chip Banana Bread
Egg_free-Chocolate_banana-Loaf-_bread_-Mini_loaves_-Muffins_-Recipezaar	Egg-Free Chocolate-Banana Loaf (Bread, Mini-Loaves, Muffins)
Eileen_s-Best-Banana-Bread-MyRecipes-212320	Eileen's Best Banana Bread
Eklutna-Banana_blueberry-Bread-Recipezaar	Eklutna Banana-Blueberry Bread
Extra-Special-Banana-Bread-Recipezaar	Extra Special Banana Bread
Extreme-Banana-Nut-Bread-_ebnb_-Allrecipes	Extreme Banana Nut Bread 'EBNB'
Fabulous-Banana-Bread-Recipezaar	Fabulous Banana Bread
Fabulous-Bundt-Pan-Banana-Bread-Recipezaar	Fabulous Bundt Pan Banana Bread
Fake-It_-Easiest-Ever-Banana-Nut-Bread-Recipezaar	Fake It! Easiest Ever Banana Nut Bread
Family-Banana-Nut-Bread-Recipe-AllRecipes-201817	Family Banana Nut Bread Recipe
Family-Favorite---Toffee-Banana-Bread-Food_com-287648	Family Favorite - Toffee Banana Bread
Famous-Banana-Bread-Recipezaar	Famous Banana Bread
Fantastic-Low_fat-Banana-Bread-Recipezaar	Fantastic Low-Fat Banana Bread
Fat-Free-Banana-Apple-Bread-Recipezaar	Fat Free Banana Apple Bread
Fat-Free-Banana-Bran-Bread-Recipezaar	Fat Free Banana Bran Bread
Fat-Free-Banana-Bread-Food_com-184656	Fat Free Banana Bread
Fat-Free-Banana-Bread-_Vegan_-Food_com-170035	Fat Free Banana Bread (Vegan)
Fat-Free-_almost_-Banana-Bread-Recipezaar	Fat Free (Almost!) Banana Bread
Fat_free_-Sugar_free-_-Cholesterol_free-Banana-Bread_-Recipezaar	Fat-Free, Sugar-Free &amp; Cholesterol-Free Banana Bread!
Favorite-Bake_off-Banana-Wheat-Quick-Bread-Recipezaar	Favorite Bake-off Banana Wheat Quick Bread
Favorite-Banana-Blueberry-Quick-Bread-Allrecipes	Favorite Banana Blueberry Quick Bread
Favorite-Banana-Bread-Recipezaar	Favorite Banana Bread
Festive-Cranberry-Banana-Bread-Food_com-128086	Festive Cranberry Banana Bread
Five-Ingredient-Miracle-Whip-Banana-Bread-Recipezaar	Five Ingredient Miracle Whip Banana Bread
Flax-Banana-Bread-Food_com-60958	Flax Banana Bread
Flax-Banana-Bread-Recipezaar	Flax Banana Bread
Flax-Banana-Bread-Recipezaar_1	Flax Banana Bread
Flour_s-Famous-Banana-Bread-Food-Network	Flour's Famous Banana Bread
Flour_s-Famous-Banana-Bread-MyRecipes-262788	Flour's Famous Banana Bread
Flour_s-Famous-Banana-Bread-Recipe-Recipezaar	Flour's Famous Banana Bread Recipe
Fool-Proof-Chocolate-Chip-Banana-Bread-Food_com-137268	Fool Proof Chocolate Chip Banana Bread
Friendship-Banana-Nut-Bread-Recipezaar	Friendship Banana Nut Bread
Fruit-And-Molasses-Sweetened-Banana-Bread-Recipezaar	Fruit and Molasses Sweetened Banana Bread
Fuzzypugs-Raspberry-Dark-Chocolate-Banana-Bread-Food_com-79172	Fuzzypugs Raspberry Dark Chocolate Banana Bread
Gingerly-Molasses-Christmas-Banana-Bread-Food_com-140139	Gingerly Molasses Christmas Banana Bread
Glazed-Caramelized-Roasted-Banana-Bread-Drop-Doughnuts-Food-Network-282245	Glazed Caramelized Roasted Banana Bread Drop Doughnuts
Glazed-Coconut-Banana-Bread-Recipezaar	Glazed Coconut Banana Bread
Gluten-Free-Banana-Bread-AllRecipes-38825	Gluten Free Banana Bread
Gluten-Free-Banana-Bread-Nikafrik-40628	Gluten Free Banana Bread
Gluten-Free-Banana-Bread-or-Cake-Food_com-161620	Gluten Free Banana Bread or Cake
Gluten-Free-Banana-Bread-Recipe-Leite_s-Culinaria-45832	Gluten-Free Banana Bread Recipe
Gluten-Free-Banana-Bread-Recipezaar	Gluten Free Banana Bread
Gluten-Free-Banana-Bread-Recipezaar_1	Gluten Free Banana Bread
Gluten-Free-Banana-Bread-Revised-Food_com-132984	Gluten Free Banana Bread Revised
Gluten-Free-Banana-Oat-Bread-Food_com-170127	Gluten-Free Banana Oat Bread
Gluten-Free-Chocolate-Peanut-Butter-Banana-Bread-Food_com-79809	Gluten Free Chocolate Peanut Butter Banana Bread
Gluten-Free-Pumpkin-Banana-Bread-Food_com-138884	Gluten Free Pumpkin Banana Bread
Gluten-Free-Tropical-Banana-Bread-Food_com-74039	Gluten Free Tropical Banana Bread
Gluten-Free-Vegan-Banana-Bread-Recipezaar	Gluten Free Vegan Banana Bread
Gluten_-Dairy-_-Egg-Free-Banana-Muffins-_Bread_-Food_com-91928	Gluten, Dairy &amp; Egg Free Banana Muffins (Bread)
Gluten_-Free-And-Vegan-Banana-Blueberry-Bread-Recipezaar	Gluten- Free and Vegan Banana Blueberry Bread
Gluten_free-Banana-Bread-Recipezaar	Gluten-Free Banana Bread
Gluten_free-Teff-Banana-Bread-_vegan-_-Soy_free_-Recipezaar	Gluten-Free Teff Banana Bread (Vegan + Soy-Free)
Going-Bananas-Banana-Bread-Food_com-122631	Going Bananas Banana Bread
Going-Bananas-for-Banana-Bread-Food_com-68735	Going Bananas for Banana Bread
Gold-Medal-Flour_s-Best-Ever-Banana-Bread-Food_com-66528	Gold Medal Flour's Best-Ever Banana Bread
Good_for_you-Banana-Bread-Recipezaar	Good-For-You Banana Bread
Graham-Cracker-Banana-Bread-Food_com-165725	Graham Cracker Banana Bread
Grain-Free-_sugar-Free-Banana-Bread-Recipezaar	Grain Free ...sugar Free Banana Bread
Grama-Neilson_s-Banana-Bread-Recipezaar	Grama Neilson's Banana Bread
Gramma_s-Banana-Bread-Muffins-Recipezaar	Gramma's Banana Bread Muffins
Grammy-Nell_s-Banana-Nut-Bread-Recipezaar	Grammy Nell's Banana Nut Bread
Gram_s-Banana-Bread-Recipezaar	Gram's Banana Bread
Grandma-Carson_s-Banana-Bread-Food_com-150162	Grandma Carson's Banana Bread
Grandma-Isabelle_s-Banana-Bread-Recipezaar	Grandma Isabelle's Banana Bread
Grandma-K_s-Incredible-Banana-Bread-Recipezaar	Grandma K's Incredible Banana Bread
Grandmas_-Banana-Nut-Bread-Recipezaar	Grandmas' Banana Nut Bread
Grandma_s-Banana-Bread-Allrecipes	Grandma's Banana Bread
Grandma_s-Banana-Bread-Food_com-140504	Grandma's Banana Bread
Grandma_s-Banana-Bread-Food_com-158848	Grandma's Banana Bread
Grandma_s-Banana-Bread-Recipezaar	Grandma's Banana Bread
Grandma_s-Banana-Bread-Recipezaar_1	Grandma's Banana Bread
Grandma_s-Banana-Bread-Recipezaar_2	Grandma's Banana Bread
Grandma_s-Banana-Nut-Bread-Recipezaar	Grandma's Banana Nut Bread
Grandma_s-Best-Ever-Banana-Nut-Bread-Recipezaar	Grandma's Best Ever Banana Nut Bread
Grandma_s-Homemade-Banana-Bread-Allrecipes	Grandma's Homemade Banana Bread
Grandmother_s-Banana-Bread-Recipezaar	Grandmother's Banana Bread
Granny-Frazier_s-Banana-Bread-Recipezaar	Granny Frazier's Banana Bread
Granny-Velma_s-Banana-Bread-Food_com-145548	Granny Velma's Banana Bread
Granny_s-Banana-Bread-Allrecipes	Granny's Banana Bread
Granny_s-Banana-Bread-With-Splenda-Food_com-93905	Granny's Banana Bread With Splenda
Great--Aunt-Marie_s-Banana-Nut-Bread-Food_com-155794	Great  Aunt Marie's Banana Nut Bread
Great-Banana-Bread-Recipezaar	Great Banana Bread
Great-Grandma_s-Banana-Bread-Recipezaar	Great Grandma's Banana Bread
Great-Granny_s-Banana-Bread-Food_com-125372	Great Granny's Banana Bread
Greatest-Banana-Nut-Bread-Ever-Recipezaar	Greatest Banana Nut Bread Ever
Greeny_s-Peanut-Butter-Banana-Bread-Food_com-75682	Greeny's Peanut Butter Banana Bread
Grilled-Banana-Bread-Ham-Steak-Sandwiches-Recipezaar	Grilled Banana Bread Ham Steak Sandwiches
Guatemalan-Banana-Bread-Recipezaar	Guatemalan Banana Bread
Guatemalan-Banana-Bread-_-Pao-De-Banano-Recipezaar	Guatemalan Banana Bread - Pao De Banano
Guatemalan-Pan-De-Banano-_Banana-Bread_-Food_com-66273	Guatemalan Pan De Banano (Banana Bread)
Guinness-Banana-Nut-Bread-Food_com-106658	Guinness Banana Nut Bread
Gwendolyn_s-Banana-Bread-Food_com-161136	Gwendolyn's Banana Bread
Hawaiian-Banana-Bread-Recipezaar	Bea's Hawaiian Banana Bread
Hawaiian-Banana-Bread-Recipezaar_1	Hawaiian Banana Bread
Hawaiian-Banana-Bread-Recipezaar_2	Hawaiian Banana Bread
Hawaiian-Banana-Bread-Recipezaar_3	Hawaiian Banana Bread
Hawaiian-Banana-Bread-With-Icing-Food_com-158300	Hawaiian Banana Bread With Icing
Hawaiian-Banana-Nut-Bread-Allrecipes	Hawaiian Banana Nut Bread
Hawaiian-Banana-Nut-Bread-Recipezaar	Hawaiian Banana Nut  Bread
Hawaiian-Banana-Nut-Bread-Recipezaar_1	Hawaiian Banana Nut Bread
Hawaiian-Hospitality-Banana-Nut-Bread-Food_com-137607	Hawaiian Hospitality Banana Nut Bread
Hawaiian-Pineapple-Banana-Bread-Food_com-178133	Hawaiian Pineapple Banana Bread
Hawaiian-Style-Banana-Bread-Food_com-120285	Hawaiian-Style Banana Bread
Hazelnut_-Chocolate-and-Banana-Rolled-Bread-Food_com-99212	Hazelnut, Chocolate and Banana Rolled Bread
Healthier-Banana-Bread-Recipezaar	Healthier Banana Bread
Healthier-Banana-Bread-Recipezaar_1	Healthier Banana Bread
Healthier-Banana-Bread-_lower-Fat_-Flax_-Ww-Flour_-Less-Sugar_-Recipezaar	Healthier Banana Bread (Lower Fat, Flax, Ww Flour, Less Sugar)
Healthier-Sour-Cream-Banana-Bread-Recipe-Chow-57221	Healthier Sour Cream&ndash;Banana Bread Recipe
Healthier-Sour-Cream-Banana-Date-Bread-Food_com-108790	Healthier Sour Cream Banana Date Bread
Healthier-Yogurt-Banana-Bread-Recipezaar	Healthier Yogurt Banana Bread
Healthiest-Banana-Bread-Natt-55250	Healthiest Banana Bread
Healthified-Banana-Bread-Food_com-150504	Healthified Banana Bread
Healthy-And-Tasty-Banana-Bread-Recipezaar	Healthy and Tasty Banana Bread
Healthy-Applesauce-Banana-Bread-Food_com-103511	Healthy Applesauce Banana Bread
Healthy-Banana-Bread-Food_com-107848	Healthy Banana Bread
Healthy-Banana-Bread-Food_com-171487	Healthy Banana Bread
Healthy-Banana-Bread-Food_com-97394	Healthy Banana Bread
Healthy-Banana-Bread-Lizzie-199397	Healthy Banana Bread
Healthy-Banana-Bread-My-Recipes	Healthy Banana Bread
Healthy-Banana-Bread-Recipezaar	Healthy Banana Bread
Healthy-Banana-Bread-Recipezaar_1	Healthy Banana Bread
Healthy-Banana-Bread-Recipezaar_2	Healthy Banana Bread
Healthy-Banana-Bread-Recipezaar_3	Healthy Banana Bread
Healthy-Banana-Bread-Recipezaar_4	Healthy Banana Bread
Healthy-Banana-Bread-Recipezaar_5	Healthy Banana Bread
Healthy-Banana-Bread-With-Blueberries-Recipezaar	Healthy Banana Bread With Blueberries
Healthy-Banana-Bread-_low-Calorie_-Low-Fat_-Low-Sugar-Food_com-162636	Healthy Banana Bread *low Calorie, Low Fat, Low Sugar
Healthy-Banana-Nut-Bread-Food_com-70832	Healthy Banana Nut Bread
Healthy-Banana-Nut-Bread-Recipezaar	Healthy Banana Nut Bread
Healthy-Banana-Nut-Bread-Recipezaar_1	Healthy Banana Nut Bread
Healthy-Banana-Oat-Bread-Recipezaar	Healthy Banana Oat Bread
Healthy-Banana-Oatmeal-Bread-Recipezaar	Healthy Banana Oatmeal Bread
Healthy-Banana-Orange-Flax-Bread-_low-Fat_-Recipezaar	Healthy Banana Orange Flax Bread (Low Fat)
Healthy-Blueberry_banana-Bread-Recipezaar	Healthy Blueberry-Banana Bread
Healthy-But-Oh_so_damn_good-Banana-Bread-Recipezaar	Healthy but Oh-So-Damn-Good Banana Bread
Healthy-Low_fat-Banana-Zucchini-Bread-Recipezaar	Healthy Low-Fat Banana Zucchini Bread
Healthy-Vegan-Banana-Bread-Food_com-177708	Healthy Vegan Banana Bread
Healthy-Wheat-Banana-Bread-Recipezaar	Healthy Wheat Banana Bread
Healthy-Whole-Grain-Banana-Bread-Recipezaar	Healthy Whole Grain Banana Bread
Healthy-Yummy-Banana-Bread-Recipezaar	Healthy Yummy Banana Bread
Healthy_-Low-Calorie-Banana-Bread-Recipezaar	Healthy, Low Calorie Banana Bread
Heathier-Banana-Pumpkin-Spice-Bread-Recipezaar	Heathier Banana Pumpkin Spice Bread
Heavenly-Banana-Bread-Recipezaar	Heavenly Banana Bread
Heavenly-Bananas-Foster-Bread-Pudding-Recipezaar	Heavenly Bananas Foster Bread Pudding
Heavenly-Chocolate-Banana-Bread-Recipezaar	Heavenly Chocolate Banana Bread
Heavenly-Healthy-Banana-Bread-from-Kaf-Food_com-67210	Heavenly Healthy Banana Bread from Kaf
Heavenly-Low-Fat_-No-Sugar-Added-Banana-Bread-Food_com-117368	Heavenly Low Fat, No Sugar Added Banana Bread
Hg_s-Top-Banana-Bread---Ww-Points-_-2-Food_com-62574	Hg's Top Banana Bread - Ww Points = 2
High-Altitude-Banana-Bread-Food_com-120365	High-Altitude Banana Bread
High-Protein-Banana-Bread-Food_com-112742	High-Protein Banana Bread
Holiday-Banana-Bread-Food_com-167536	Holiday Banana Bread
Holiday-Banana-Bread-Food_com-185842	Holiday Banana Bread
Holiday-Banana-Bread-Food_com-93660	Holiday Banana Bread
Holiday-Banana-Bread-Pudding-Martha-Stewart-239680	Holiday Banana Bread Pudding
Honduran-Banana-Bread-Recipezaar	Honduran Banana Bread
Honey-and-Whole-Wheat-Banana-Bread-Food_com-105326	Honey and Whole Wheat Banana Bread
Honey-Banana-Bread-Food_com-185774	Honey Banana Bread
Honey-Banana-Bread-Recipezaar	Honey Banana Bread
Honey-Banana-Nut-Bread-Recipezaar	Honey Banana Nut Bread
Honey-Banana-Whole-Wheat-Bread_bread-Machine-Recipezaar	Honey Banana Whole Wheat Bread-Bread Machine
Honey-Oat-Banana-Bread-Recipezaar	Honey Oat Banana Bread
Honey_banana-Bread-Recipezaar	Honey-Banana Bread
Hungry-Girl_s-Banana-Bread-Pudding-Recipezaar	Hungry Girl's Banana Bread Pudding
Hungry-Girl_s-Better-Off-Banana-Bread-Recipezaar	Hungry Girl's Better off Banana Bread
I-Can_t-Believe-It_s-Reduced_fat-Whole-Wheat-Banana-Bread-Recipezaar	I Can't Believe It's Reduced-Fat Whole Wheat Banana Bread
Iced-Banana-Bread-Food_com-161612	Iced Banana Bread
Idiot-Proof-Banana-Bread-Food_com-190011	Idiot-Proof Banana Bread
Impossibly-Moist-Banana-Bread-Recipezaar	Impossibly Moist Banana Bread
Incredible-Banana-Bread-Food_com-176302	Incredible Banana Bread
Indescribably-Delicious-Banana-Bread-Food_com-137621	Indescribably Delicious Banana Bread
Insainly-Sweet-Banana-Bread-Recipezaar	Insainly Sweet Banana Bread
Insane-Banana-Nut-Bread-Food_com-98479	Insane Banana Nut Bread
Insanely-Healthy-Banana-Bread-Recipezaar	Insanely Healthy Banana Bread
Instant-Banana-Bread-Food_com-104612	Instant Banana Bread
Island-Style-Banana-Bread-Recipezaar	Island Style Banana Bread
Jacked-up-Banana-Bread-Food_com-82316	Jacked up Banana Bread
Jamaican-Banana-Bread-Food_com-180175	Jamaican Banana Bread
Jamaican-Banana-Bread-My-Recipes	Jamaican Banana Bread
Jamaican-Banana-Bread-Recipezaar_1	Jamaican Banana Bread
James-Beard-Banana-Bread-Recipezaar	James Beard Banana Bread
Janet_s-Banana-Bread-Food_com-73963	Janet's Banana Bread
Janet_s-Famous-Banana-Nut-Bread-Allrecipes	Janet's Famous Banana Nut Bread
Janet_s-Rich-Banana-Bread-Allrecipes	Janet's Rich Banana Bread
Janine_s-Best-Banana-Bread-Allrecipes	Janine's Best Banana Bread
Jan_s-Multi_bran-Peach_-Banana-Bread-Recipezaar	Jan's Multi-Bran Peach, Banana Bread
Jif-Banana-Bread-Recipezaar	Jif Banana Bread
John_s-Banana-Bread-Recipezaar	John's Banana Bread
Joseph_s-Bellyicious-Banana-Blueberry-Bread-Recipezaar	Joseph's Bellyicious Banana Blueberry Bread
Joyce_s-Unbeatable-Banana-Bread-Recipezaar	Joyce's Unbeatable Banana Bread
Joy_s-Amazing-Banana-Bread-RecipeZaar-58625	Joy's Amazing Banana Bread
Juanita_s-Banana-Bread-Food_com-145686	Juanita's Banana Bread
Just-Another-Banana-Bread-Recipezaar	Just Another Banana Bread
Kanai-Inn-Banana-Bread-Food_com-95743	Kanai Inn Banana Bread
Karen_s-Banana-Bread-Recipezaar	Karen's Banana Bread
Katie_s-Healthy-Banana-Bread-Recipezaar	Katie's Healthy Banana Bread
Katy_s-Banana-Bread-Recipezaar	Katy's Banana Bread
Kb-Banana-Bread-Recipezaar	Kb Banana Bread
Kelly_s-Banana-Bread-Recipezaar	Kelly's Banana Bread
Kelly_s-Blueberry-Banana-Bread-Recipezaar	Kelly's Blueberry Banana Bread
Kim_s-Banana-Bread-Recipezaar	Kim's Banana Bread
Kingfisher_s-Banana-Bread-Pudding-Recipezaar	Kingfisher's Banana Bread Pudding
Kona-Banana-Bread-Food_com-177702	Kona Banana Bread
Kona-Banana-Bread-Recipezaar	Kona Banana Bread
Kona-Inn-Banana-Bread-Food-Network	Kona Inn Banana Bread
Kona-Inn-Banana-Bread-Recipezaar	Kona Inn Banana Bread
Kona-Inn-Banana-Bread-Recipezaar_1	Kona Inn Banana Bread
Kyle_s-Banana-Bread-Food_com-154513	Kyle's Banana Bread
Large-Batch-Banana-Nut-Bread-Recipezaar	Large Batch Banana Nut Bread
Last-Try-Banana-Bread-Recipezaar	Last Try Banana Bread
Leftover-Banana-Bread-Trifle-Recipezaar	Leftover Banana Bread Trifle
Lela_s-Banana-Nut-Bread-Recipezaar	Lela's Banana Nut Bread
Lemon-Banana-Bread-Food_com-133487	Lemon Banana Bread
Lemon-Blueberry-Banana-Bread-Food_com-99097	Lemon Blueberry Banana Bread
Lemon-Syrup-Banana-Bread-Recipezaar	Lemon Syrup Banana Bread
Lemony-olive-oil-banana-bread-308645	Lemony Olive Oil Banana Bread
Light-As-A-Feather-Banana-Bread-Recipezaar	Light As a Feather Banana Bread
Light-Banana-Bread-Food_com-118684	Light Banana Bread
Light-Banana-Bread-Food_com-181015	Light Banana Bread
Light-Banana-Bread-Recipezaar	Light Banana Bread
Lightened-up-Banana-Bread-Food_com-103610	Lightened up Banana Bread
Lightened-Up-Banana-Bread-Food_com-291878	Lightened-Up Banana Bread
Lightened-Up-Special-Banana-Bread-Recipe-Taste-of-Home-44566	Lightened-Up Special Banana Bread Recipe
Lightened_up-Banana-Bread-Recipezaar	Lightened-Up Banana Bread
Lighter-Zucchini-Banana-Bread-Recipezaar	Lighter Zucchini Banana Bread
Liisa_s-Best-Banana-Nut-Bread-_-Really_it_s-That-Good_-Recipezaar	Liisa's Best Banana Nut Bread - really-it's that good!
Like-Ihop-Banana-Bread-French-Toast-Food_com-170885	Like Ihop Banana Bread French Toast
Linda_s-Banana-Bread-Recipezaar	Linda's Banana Bread
Lisa_s-Superb-Banana-Walnut-Bread-Recipezaar	Lisa's Superb Banana Walnut Bread
Lite-_But-Yummy_-Banana-Bread-Food_com-133464	Lite (But Yummy!) Banana Bread
Lite-_n-Moist-Banana-Nut-Bread-Food_com-112247	Lite 'n Moist Banana Nut Bread
Little-Al_s-Banana-Bread-Recipezaar	Little Al's Banana Bread
Livestrong-Banana-Bread-Recipezaar	Livestrong Banana Bread
Lizzie_s-Favorite-Banana-Bread-With-Chocolate-Recipezaar	Lizzie's Favorite Banana Bread With Chocolate
Loaded-Banana-Bread_vegan-Style_-Food_com-97656	Loaded Banana Bread...vegan Style!
Lorin_s-Banana-Bread-for-Nursing-Mothers_-Lorin_s-Lactation-Banana-Bread-Recipe-Chow-56492	Lorin's Banana Bread for Nursing Mothers/ Lorin's Lactation Banana Bread Recipe
Low-Cal-Banana-Bread-Food_com-175785	Low-Cal Banana Bread
Low-Calorie-Banana-Bread-Recipezaar	Low Calorie Banana Bread
Low-Calorie-Banana-Bread-Recipezaar_1	Low Calorie Banana Bread
Low-Calorie-Banana-Oatmeal-Bread-Recipezaar	Low Calorie Banana Oatmeal Bread
Low-Calorie-Whole-Wheat-Banana-Bread-Recipezaar	Low Calorie Whole Wheat Banana Bread
Low-Fat-And-Delicious-Banana-Raspberry-Bread-Recipezaar	Low Fat and Delicious Banana Raspberry Bread
Low-Fat-Apple-Banana-Raisin-Bread-Recipezaar	Low Fat Apple Banana Raisin Bread
Low-Fat-Banana-And-Fruit-Bread-Recipezaar	Low Fat Banana and Fruit Bread
Low-Fat-Banana-Bread-AllRecipes-40041	Low-Fat Banana Bread
Low-Fat-Banana-Bread-Food_com-163410	Low Fat Banana Bread
Low-Fat-Banana-Bread-Food_com-204139	Low Fat Banana Bread
Low-Fat-Banana-Bread-Food_com-287546	Low Fat Banana Bread
Low-Fat-Banana-Bread-Food_com-69491	Low Fat Banana Bread
Low-Fat-Banana-Bread-Food_com-98177	Low Fat Banana Bread
Low-Fat-Banana-Bread-Or-Cake-Recipezaar	Low Fat Banana Bread or Cake
Low-Fat-Banana-Bread-Recipezaar	Low Fat Banana Bread
Low-Fat-Banana-Bread-Recipezaar_1	Low Fat Banana Bread
Low-Fat-Banana-Bread-Recipezaar_2	Low Fat Banana Bread
Low-Fat-Banana-Bread-Recipezaar_3	Low Fat Banana Bread
Low-Fat-Banana-Bread-Recipezaar_4	Low Fat Banana Bread
Low-Fat-Banana-Bread-Recipezaar_5	Low Fat Banana Bread
Low-Fat-Banana-Bread-Recipezaar_6	Low Fat Banana Bread
Low-Fat-Banana-Bread-Recipezaar_7	Low Fat Banana Bread
Low-Fat-Banana-Bread-Recipezaar_8	Low Fat Banana Bread
Low-Fat-Banana-Bread-Remake-_-_-Recipezaar	Low Fat Banana Bread Remake !  :)
Low-Fat-Banana-Bread-W_splenda-Recipezaar	Low Fat Banana Bread W/Splenda
Low-Fat-Banana-Nut-Bread-Food_com-188015	Low Fat Banana Nut Bread
Low-Fat-Banana-Nut-Bread-Food_com-68952	Low Fat Banana Nut Bread
Low-Fat-Banana-Nut-Bread-Recipezaar	Low Fat Banana Nut Bread
Low-Fat-Banana-Oat-Bread-Recipezaar	Low Fat Banana Oat Bread
Low-Fat-Banana-Spelt-Bread-Recipezaar	Low Fat Banana Spelt Bread
Low-Fat-Banana-Spice-Bread-Food_com-64958	Low-Fat Banana Spice Bread
Low-Fat-Double-Chocolate-Banana-Bread-Food_com-136778	Low-Fat Double Chocolate Banana Bread
Low-Fat-Fruit-and-Nut-Banana-Bread-Food_com-148474	Low Fat Fruit and Nut Banana Bread
Low-Fat-Honey-Banana-Bread-Recipezaar	Low Fat Honey Banana Bread
Low-Fat-Secret-Ingredient-Banana-Bread-Recipezaar	Low Fat Secret Ingredient Banana Bread
Low-Fat-Soy-Banana-Bread-Recipezaar	Low Fat Soy Banana Bread
Low-Fat-Stevia-Banana-Bread-Recipezaar	Low Fat Stevia Banana Bread
Low-Fat-Strawberry-Banana-Bread-Food_com-80056	Low Fat Strawberry Banana Bread
Low-Fat-Sugar-Free-Banana-Bread-Food_com-118204	Low Fat-Sugar Free Banana Bread
Low-Fat-Sugar-Free-Banana-Bread-Recipezaar	Low Fat Sugar Free Banana Bread
Low-Fat-Vegan-Banana-Bread-Recipezaar	Low Fat Vegan Banana Bread
Low-Fat-Wholesome-Banana-Bread-Recipezaar	Low Fat Wholesome Banana Bread
Low-Fat-_but-You-Wouldn_t-Know-It_-Banana-Bread-Recipezaar	Low Fat (But You Wouldn't Know It) Banana Bread
Low-Gi-Blueberry-_-Banana-Bread-Food_com-184059	Low Gi Blueberry &amp; Banana Bread
Low-Sugar-Banana-Bread-Recipezaar	Low Sugar Banana Bread
Lower-Calorie-Banana-Bread-Recipezaar	Lower Calorie Banana Bread
Lower-Fat-Banana-Bread-I-Allrecipes	Lower Fat Banana Bread I
Lower-Fat-Banana-Bread-Ii-Allrecipes	Lower Fat Banana Bread II
Lower-Fat-Banana-Bread-_-Muffins-Food_com-177467	Lower Fat Banana Bread / Muffins
Lower-Fat-Banana-Nut-Bread-Allrecipes	Lower Fat Banana Nut Bread
Low_calorie-Banana-Bread-Recipezaar	Low-Calorie Banana Bread
Low_fat-Applesauce-Banana-Bread-Recipezaar	Low-Fat Applesauce Banana Bread
Low_fat-Banana-Bread-Epicurious	Low-Fat Banana Bread
Low_fat-Banana-Bread-Recipezaar	Low-Fat Banana Bread
Low_fat-Banana-Bread-Recipezaar_1	Low-Fat Banana Bread
Low_fat-Full_flavor-Banana-Bread-Recipezaar	Low-Fat Full-Flavor Banana Bread
Low_fat_-High_fiber-Yummy-Banana-Bread-Recipezaar	Low-Fat, High-Fiber Yummy Banana Bread
Low_sugar-Banana-Bread-Recipezaar	Low-Sugar Banana Bread
Lynda_s-Banana-Bread-Recipezaar	Lynda's Banana Bread
Lynne_s-Banana-Bread-Food_com-137256	Lynne's Banana Bread
Macadamia-Banana-Bread-Recipezaar	Macadamia Banana Bread
Macadamia-Banana-Bread-Recipezaar_1	Macadamia Banana Bread
Mackinaw-Island-Banana-Bread-Recipezaar	Mackinaw Island Banana Bread
Magnificent_-Moist_-Banana-Bread-Recipezaar	Magnificent, Moist, Banana Bread
Mamas-Banana-Bread-Food_com-72923	Mamas Banana Bread
Mamaw_s-Banana-Bread-Recipezaar	Mamaw's Banana Bread
Mama_s-Banana-Bread-Food_com-92516	Mama's Banana Bread
Mama_s-Banana-Bread-Recipezaar	Mama's Banana Bread
Mama_s-Old_time-Banana-Nut-Bread-Recipezaar	Mama's Old-Time Banana Nut Bread
Mango-Banana-Bread-Recipezaar	Mango Banana Bread
Mango-Banana-Bread-Recipezaar_1	Mango Banana Bread
Maple-Banana-Bread-Allrecipes	Maple Banana Bread
Maple-Banana-Bread-Food_com-131436	Maple Banana Bread
Maple-Banana-Nut-Bread-Recipezaar	Maple Banana Nut Bread
Maple-Oat-Banana-Bread-RecipeZaar-58569	Maple Oat Banana Bread
Maple-Syrup-Banana-Bread-RecipeZaar-60027	Maple Syrup Banana Bread
Maple-Walnut-Banana-Bread-Recipezaar	Maple Walnut Banana Bread
Maple-Walnut-Banana-Bread-TasteOfHome	Maple Walnut Banana Bread
Maple_banana-Bread-With-Flax-Recipezaar	Maple-Banana Bread With Flax
Marbled-Banana-Bread_Muffins-Food_com-95322	Marbled Banana Bread/Muffins
Marbled-Chocolate-Banana-Bread-Food_com-150556	Marbled-Chocolate Banana Bread
Marbled-_-Chocolate-Banana-Bread-Recipezaar	Marbled - Chocolate Banana Bread
Marbled_chocolate-Banana-Bread-My-Recipes	Marbled-Chocolate Banana Bread
Maria_s-Best-Banana-Bread-Recipezaar	Maria's Best Banana Bread
Marie_s-Vegan-Banana-Pecan-Bread-Food_com-76671	Marie's Vegan Banana Pecan Bread
Martha-Stewart_s-Banana-Bread-Food_com-76704	Martha Stewart's Banana Bread
Martha-Stewart_s-Banana-Bread-Recipezaar	Martha Stewart's Banana Bread
Mary-Ann_s-Banana-Bread-Recipezaar	Mary Ann's Banana Bread
Maui-Banana-Bread-_by-Peg-Bracken_-Recipezaar	Maui Banana Bread (By Peg Bracken)
Max-And-Mom_s-Over_the_top-Banana-Bread-Recipezaar	Max and Mom's Over-The-Top Banana Bread
Mean-Chef_s-Banana-Nut-Bread-Recipezaar	Mean Chef's Banana Nut Bread
Mels-Basic-Banana-Bread-Recipezaar	Mels Basic Banana Bread
Mels-Healthy-Banana-Bread-Recipezaar	Mels Healthy Banana Bread
Mels-Healthy-Banana-Bread-Recipezaar_1	Mels Healthy Banana Bread
Melt-And-Mix-Banana-Bread-Recipezaar	Melt and Mix Banana Bread
Melt-And-Mix-Banana-Bread-Recipezaar_1	Melt and Mix Banana Bread
Melt-in-Your-Mouth-Banana-Bread---Healthy-Version-Food_com-82061	Melt in Your Mouth Banana Bread - Healthy Version
Melt-In-Your-Mouth-Banana-Bread-Recipezaar	Melt in Your Mouth Banana Bread
Melt-In-Your-Mouth-Banana-Bread-Recipezaar_1	Melt in Your Mouth Banana Bread
Mel_s-Banana-Bread-Recipezaar	Mel's Banana Bread
Memaw_s-Banana-Bread-Recipezaar	Memaw's Banana Bread
Michele_s-Banana-Nut-Bread-Recipezaar	Michele's Banana Nut Bread
Michelle_s-Banana-Chocolate-Gorilla-Bread-Food-Network-283669	Michelle's Banana Chocolate Gorilla Bread
Microwave-Banana-Bread-Pudding-Recipezaar	Microwave Banana Bread Pudding
Microwave-Tofu-Banana-Bread-Allrecipes	Microwave Tofu Banana Bread
Mimi_s-Banana-Bread-Recipezaar	Daughter's Banana Bread
Mini-Banana-Breads-Recipezaar	Mini Banana Breads
Mini-Banana-Cranberry-Nut-Bread-Loaves-MyRecipes-238127	Mini Banana-Cranberry-Nut Bread Loaves
Miracle-Whip-_take-5_--Banana-Bread-Food_com-116908	Miracle Whip &quot;take 5&quot;  Banana Bread
Miriam_s-Banana-Nut-Bread-Recipezaar	Miriam's Banana Nut Bread
Mocha-Banana-Bread-Recipezaar	Mocha Banana Bread
Modified-Banana-Zucchini-Bread-Food_com-144803	Modified Banana Zucchini Bread
Moist-and-Delicious-Banana-Bread-Food_com-119835	Moist and Delicious Banana Bread
Moist-And-Delicious-Banana-Bread-Recipezaar	Moist and Delicious Banana Bread
Moist-and-Easy-Banana-Bread-Food_com-178866	Moist and Easy Banana Bread
Moist-Banana-Bread-Food_com-97278	Moist Banana Bread
Moist-Banana-Bread-Recipezaar	Moist Banana Bread
Moist-Banana-Bread-Recipezaar_1	Moist Banana Bread
Moist-Banana-Bread-Recipezaar_2	Moist Banana Bread
Moist-Banana-Bread-Recipezaar_3	Moist Banana Bread
Moist-Banana-Bread-Recipezaar_4	Moist Banana Bread
Moist-Banana-Bread-Recipezaar_5	Moist Banana Bread
Moist-Banana-Bread-Recipezaar_6	Moist Banana Bread
Moist-Banana-Bread_---Dairy-Free-Food_com-183644	Moist Banana Bread! - Dairy Free
Moist-Banana-Bundt-Cake-_-Bread-With-Orange-Glaze-Food_com-144188	Moist Banana Bundt Cake / Bread With Orange Glaze
Moist-Banana-Nut-Bread-Recipezaar	Moist Banana Nut Bread
Moist-Banana-Nut-Bread-With-Orange-Glaze-Food_com-88082	Moist Banana Nut Bread With Orange Glaze
Moist-Banana-Peanut-Bread-Food_com-121861	Moist Banana Peanut Bread
Moist-Banana-Pecan-Bread-Recipezaar	Moist Banana Pecan Bread
Moist-Banana-Pumpkin-Bread-Recipezaar	Moist Banana Pumpkin Bread
Moist-Banana-Raisin-Bread-Allrecipes	Moist Banana Raisin Bread
Moist-Banana-Walnut-Bread-Recipezaar	Moist Banana Walnut Bread
Moist-Chocolate-Chip-Banana-Bread-Food_com-70066	Moist Chocolate Chip Banana Bread
Moist-Chocolate-Chip-Banana-Bread-Recipezaar	Moist Chocolate Chip Banana Bread
Moist-Healthy-Banana-Bread-Food_com-288005	Moist Healthy Banana Bread
Molasses-Banana-Bread-Allrecipes	Molasses Banana Bread
Molasses_oat-Banana-Bread-My-Recipes	Molasses-Oat Banana Bread
Molasses_oat-Banana-Bread-Or-Muffins-_lower-Fat_-Recipezaar	Molasses-Oat Banana Bread or Muffins (Lower Fat)
Mom-Cooper_s-Banana-Bread-Recipezaar	Mom Cooper's Banana Bread
Momma-Callie_s-Banana-Nut-Bread-with-Honey-Butter-Food-Network-274574	Momma Callie's Banana Nut Bread with Honey Butter
Mommy_s-Banana-Bread-AllRecipes-202580	Mommy's Banana Bread
Moms-Banana-Bread-Recipezaar	Moms Banana Bread
Moms-Best-Banana-Bread-Food_com-84808	Moms Best Banana Bread
Mom_s-Apricot-Banana-Bread-Recipezaar	Mom's Apricot Banana Bread
Mom_s-Banana-Bread-Food_com-112836	Mom's Banana Bread
Mom_s-Banana-Bread-Food_com-66443	Mom's Banana Bread
Mom_s-Banana-Bread-My-Recipes	Mom's Banana Bread
Mom_s-Banana-Bread-or-Muffins-Food_com-120751	Mom's Banana Bread or Muffins
Mom_s-Banana-Bread-Recipezaar	Mom's Banana Bread
Mom_s-Banana-Bread-Recipezaar_1	Mom's Banana Bread
Mom_s-Banana-Bread-Recipezaar_10	Mom's Banana Bread
Mom_s-Banana-Bread-Recipezaar_11	Mom's Banana Bread
Mom_s-Banana-Bread-Recipezaar_12	Mom's Banana Bread
Mom_s-Banana-Bread-Recipezaar_13	Mom's Banana Bread
Mom_s-Banana-Bread-Recipezaar_14	Mom's Banana Bread
Mom_s-Banana-Bread-Recipezaar_2	Mom's Banana Bread
Mom_s-Banana-Bread-Recipezaar_3	Mom's Banana Bread
Mom_s-Banana-Bread-Recipezaar_4	Mom's Banana Bread
Mom_s-Banana-Bread-Recipezaar_5	Mom's Banana Bread
Mom_s-Banana-Bread-Recipezaar_6	Mom's Banana Bread
Mom_s-Banana-Bread-Recipezaar_7	Mom's Banana Bread
Mom_s-Banana-Bread-Recipezaar_8	Mom's Banana Bread
Mom_s-Banana-Bread-Recipezaar_9	Mom's Banana Bread
Mom_s-Banana-Bread-with-Chocolate-Chips-Food-Network-279912	Mom's Banana Bread with Chocolate Chips
Mom_s-Banana-Bread-_goes-Fast_-Recipezaar	Mom's Banana Bread (Goes Fast!)
Mom_s-Best-Banana-Bread-Food_com-158175	Mom's Best Banana Bread
Mom_s-Best-Banana-Bread-Recipezaar	Mom's Best Banana Bread
Mom_s-Deliciously-Moist-Banana-Nut-Bread-Recipezaar	Mom's Deliciously Moist Banana Nut Bread
Montessori-School-Banana-Bread-Recipezaar	Montessori School Banana Bread
More-Bananas-Banana-Bread-Food_com-122832	More Bananas Banana Bread
Most-Excellent-And-Healthy-Banana-Bread-Recipezaar	Most Excellent and Healthy Banana Bread
Mostly-Mom_s-Banana-Bread-Food_com-292534	Mostly Mom's Banana Bread
Mother-in-Law-Banana-Bread_-Food_com-108367	Mother in Law Banana Bread!
Mother_s-Banana-Bread-MyRecipes-247526	Mother's Banana Bread
Mother_s-Banana-Nut-Bread-Recipezaar	Mother's Banana Nut Bread
Mpls_-Public-High-School-_-Home-Ec_-Banana-Bread-Recipezaar	Mpls. Public High School - Home Ec. Banana Bread
Mrs_-April_s-Banana-Bread-Recipezaar	Mrs. April's Banana Bread
Mrs_-Kurtz_s-Banana-Bread-Allrecipes	Mrs. Kurtz's Banana Bread
Mum_s-Ono-Banana-Bread_-Recipezaar	Mum's Ono Banana Bread!
My-Aunt_s-Banana-Bread-AllRecipes	My Aunt's Banana Bread
My-Banana-Bread-Recipezaar	My Banana Bread
My-Favorite-Banana-Bread-Food_com-83991	My Favorite Banana Bread
My-Favorite-Banana-Bread-Muffins-_modified-To-Be-Healthier_-Recipezaar	My Favorite Banana Bread Muffins   *modified to Be Healthier*
My-Favorite-Banana-Bread-Recipezaar_1	My Favorite Banana Bread
My-Favorite-Banana-Bread-Recipezaar_2	My Favorite Banana Bread
My-Granny_s-Banana-Bread-Food_com-292740	My Granny's Banana Bread
My-Incredibily-Popular-Banana-Bread-Recipezaar	My Incredibily Popular Banana Bread
My-Mama_s-Banana-Bread-Food_com-102837	My Mama's Banana Bread
My-Mommy_s-Banana-Bread-Recipezaar	My Mommy's Banana Bread
My-Mom_s-Banana-Bread-Food_com-189027	My Mom's Banana Bread
My-Mom_s-Famous-Banana-Bread-Recipe-Food_com-82858	My Mom's Famous Banana Bread Recipe
My-Mother_s-Banana-Bread-Recipezaar	My Mother's Banana Bread
Nana-Banana_s-Perfect-Banana-Bread-Recipezaar	Nana Banana's Perfect Banana Bread
Nana-Hassard_s-Super-Simple-Banana-Bread-Recipezaar	Nana Hassard's Super Simple Banana Bread
Nana_s-Banana-Bread-Food_com-116926	Nana's Banana Bread
Nana_s-Banana-Bread-Food_com-149149	Nana's Banana Bread
Nana_s-Banana-Bread-Food_com-185187	Nana's Banana Bread
Nana_s-Banana-Bread-MyRecipes-265736	Nana&rsquo;s Banana Bread
Nana_s-Banana-Bread-Recipezaar	Nana's Banana Bread
Nana_s-Banana-Bread-Recipezaar_1	Nana's Banana Bread
Nana_s-Banana-Bread-Recipezaar_2	Nana's Banana Bread
Nancy_s-Banana-Bread-Recipezaar	Nancy's Banana Bread
Nanna_s-Banana-Bread-Allrecipes	Nanna's Banana Bread
Nanny_s-Banana-Nut-Bread-Food_com-93527	Nanny's Banana-Nut Bread
Nee_s-Banana-Bread-Recipezaar	Nee's Banana Bread
Never-Fail-Banana-Bread-Recipezaar	Never Fail Banana Bread
New-and-Improved-Chocolate-Chip-Banana-Bread-Food_com-178511	New and Improved Chocolate Chip Banana Bread
Nick_s-Banana-Bread-Recipezaar	Nick's Banana Bread
Nif_s-Eggnog-Banana-Bread-Food_com-93301	Nif's Eggnog Banana Bread
Nigella-Lawson-Banana-Bread-Recipezaar	Nigella Lawson Banana Bread
Nikki_s-Banana-Bread-Muffins_-Healthy-Recipezaar	Nikki's Banana Bread Muffins- Healthy
No-Butter-Banana-Bread-Food_com-169992	No-Butter Banana Bread
No-Butter-Banana-Bread-Food_com-83069	No Butter Banana Bread
No-Sugar-Added-Banana-Bread-Recipezaar	No Sugar Added Banana Bread
No-Sugar-Added-Peachy-Banana-Bread-Food_com-107587	No Sugar Added Peachy Banana Bread
Non_fat-Banana-Bread-Recipezaar	Non-Fat Banana Bread
Norm_s-Banana-Nut-Bread-Recipezaar	Norm's Banana Nut Bread
Now-That_s-Banana-Bread_-Recipezaar	Now That's Banana Bread!
No_egg_-No_oil_-Banana-Raisin-Whole-Wheat-Bread-Recipezaar	No-Egg, No-Oil, Banana Raisin Whole Wheat Bread
Nthochi-Bread---Malawi-Banana-Bread-Food_com-182863	Nthochi Bread - Malawi Banana Bread
Nthochi-_banana_-Bread-Recipezaar	Nthochi (Banana) Bread
Nutella-and-Banana-Bread-Food_com-131861	Nutella and Banana Bread
Nutella-and-Banana-Bread-MomdeCuisine-46502	Nutella and Banana Bread
Nutella-Banana-Bread-Food_com-128919	Nutella Banana Bread
Nutella-Banana-Bread-Food_com-132833	Nutella Banana Bread
Nutella-Banana-Brioche-Bread-Pudding-Food-Network-210895	Nutella Banana Brioche Bread Pudding
Nutty-And-Wheaty-Banana-Bread-Recipezaar	Nutty and Wheaty Banana Bread
Nutty-Banana-Bread-Allrecipes	Nutty Banana Bread
Nutty-Banana-Bread-Food_com-162570	Nutty Banana Bread
Nutty-Banana-Bread-Food_com-163607	Nutty Banana Bread
Nutty-Banana-Bread-Recipezaar	Nutty Banana Bread
Oat-Whole-Wheat-Banana-Nut-Bread-Food_com-139653	Oat-Whole Wheat Banana Nut Bread
Oatmeal-Banana-Bread-Cookies-Food_com-82955	Oatmeal Banana Bread Cookies
Oatmeal-Banana-Bread-Pancakes-Recipezaar	Oatmeal Banana Bread Pancakes
Oatmeal-Banana-Bread-Recipezaar	Oatmeal Banana Bread
Oatmeal-Banana-Bread-Recipezaar_1	Oatmeal Banana Bread
Oatmeal-Banana-Cinnamon-Bread-Allrecipes	Oatmeal Banana Cinnamon Bread
Oatmeal-Banana-Nut-Bread-Allrecipes	Oatmeal Banana Nut Bread
Oat_-Flax-_n-Banana-Bread-Food_com-63710	Oat, Flax 'n Banana Bread
Oat_chip-Banana-Bread-TasteOfHome	Oat-Chip Banana Bread
Oh-so-Tasty_very-Healthy_blueberry-Banana-Bread-Food_com-177952	Oh so Tasty...very Healthy...blueberry-Banana Bread
Old-Fashioned-Banana-Bread-Food_com-174276	Old Fashioned Banana Bread
Old-Fashioned-Banana-Bread-Pudding-Food_com-86916	Old Fashioned Banana Bread Pudding
Old-Fashioned-Banana-Bread-Recipezaar	Old Fashioned Banana Bread
Old-Fashioned-Banana-Bread-Recipezaar_1	Old Fashioned Banana Bread
Old-Fashioned-Banana-Bread-Recipezaar_2	Old Fashioned Banana Bread
Old-Fashioned-Yeasted-Banana-Nut-Bread-Recipezaar	Old Fashioned Yeasted Banana Nut Bread
Old-Skool-Banana-Bread-Recipezaar	Old Skool Banana Bread
Old_fashioned-Fragrant-Banana-Bread-Recipezaar	Old-Fashioned Fragrant Banana Bread
Old_school-Banana-Bread-Recipezaar	Old-School Banana Bread
One-Pan-Banana-Bread-Food_com-164729	One Pan Banana Bread
One-Pan-Banana-Bread-Recipezaar	One Pan Banana Bread
Only-One-Vegan-Banana-Bread-Recipezaar	Only One Vegan Banana Bread
Orange-Banana-Bread-Food-Network-283685	Orange Banana Bread
Orange-Banana-Bread-Recipezaar	Orange Banana Bread
Orange-Banana-Nut-Bread-Recipezaar	Orange Banana Nut Bread
Orange-Banana-Nut-Bread-TasteOfHome	Orange Banana Nut Bread
Orange-Banana_nut-Bread-My-Recipes	Orange Banana-Nut Bread
Orange-Pecan-Topped-Cream-Cheese-Banana-Nut-Bread-Food_com-61196	Orange Pecan Topped Cream Cheese Banana Nut Bread
Orange-Pecan-Topped-Cream-Cheese-Banana-Nut-Bread-MyRecipes-229365	Orange-Pecan-Topped Cream Cheese-Banana-Nut Bread
Orange-You-Glad-I-Said-_-Banana_-Bread-Recipezaar	Orange You Glad I Said &quot; Banana&quot; Bread
Our-Favorite-Banana-Bread-Recipezaar	Our Favorite Banana Bread
Oz_s-Banana_nut-And-Raisin-Bread-For-Abm-Allrecipes	Oz's Banana-Nut and Raisin Bread for ABM
Passover-Banana-Bread-Recipezaar	Passover Banana Bread
Patti_s-Banana-Bread-Food_com-143873	Patti's Banana Bread
Pat_s-Cranberry-Banana-Bread-Recipezaar	Pat's Cranberry Banana Bread
Paula-Deen-Banana-Bread-Recipezaar	Paula Deen Banana Bread
Paula-Deen_s-Banana-Nut-Bread-Food_com-127544	Paula Deen's Banana Nut Bread
Peanut-Butter-And-Banana-Bread-Finger-Sandwiches-Food-Network	Peanut Butter and Banana Bread Finger Sandwiches
Peanut-Butter-Banana-Bread-Food_com-125334	Peanut Butter Banana Bread
Peanut-Butter-Banana-Bread-Food_com-177885	Peanut Butter Banana Bread
Peanut-Butter-Banana-Bread-Food_com-188905	Peanut Butter Banana Bread
Peanut-Butter-Banana-Bread-MyRecipes-237865	Peanut Butter Banana Bread
Peanut-Butter-Banana-Bread-MyRecipes-244235	Peanut Butter Banana Bread
Peanut-Butter-Banana-Bread-Pudding-Food_com-183530	Peanut Butter-Banana Bread Pudding
Peanut-Butter-Banana-Bread-Recipezaar	Peanut Butter Banana Bread
Peanut-Butter-Banana-Bread-Recipezaar_1	Peanut Butter Banana Bread
Peanut-Butter-Banana-Bread-Recipezaar_3	Peanut Butter Banana Bread
Peanut-Butter-Banana-Bread-Recipezaar_4	Peanut Butter Banana Bread
Peanut-Butter-Banana-Bread-TasteOfHome	Peanut Butter Banana Bread
Peanut-Butter-Banana-Chocolate-Chip-Bread-Food_com-89034	Peanut Butter Banana Chocolate Chip Bread
Peanut-Butter-Banana-Sandwich-Bread-Puddings-With-Dark-Caramel-S-Food_com-128245	Peanut Butter-Banana Sandwich Bread Puddings With Dark Caramel S
Peanut-Butter-Banana-Sandwich-Bread-Puddings-With-Dark-Caramel-Sauce-MyRecipes-212110	Peanut Butter-Banana Sandwich Bread Puddings With Dark Caramel Sauce
Peanut-Butter-Chocolate-Chip-Banana-Bread-Recipezaar	Peanut Butter Chocolate Chip Banana Bread
Peanut-Butter-Cream-Cheese-Banana-Nut-Bread-_Healthier-Verison_-RecipeZaar-59706	Peanut Butter Cream Cheese Banana Nut Bread (Healthier Verison)
Peanut-Butter-Streusel-Topped-Cream-Cheese-Banana-Nut-Bread-Food_com-103403	Peanut Butter Streusel-Topped Cream Cheese Banana-Nut Bread
Peanut-Butter-Streusel-Topped-Cream-Cheese-Banana-Nut-Bread-MyRecipes-229383	Peanut Butter Streusel-Topped Cream Cheese-Banana-Nut Bread
Peanut-Butter-_-Chocolate-Chips-Banana-Bread-Recipezaar	Peanut Butter &amp; Chocolate Chips Banana Bread
Peanut-Butter-_n_-Banana-Bread-Food_com-83389	Peanut Butter 'n' Banana Bread
Peanut-Butter_chocolate-Chip-Banana-Bread-Recipezaar	Peanut Butter-Chocolate Chip Banana Bread
Peanut-Butter_cream-Cheese_banana_nut-Bread-My-Recipes	Peanut Butter-Cream Cheese-Banana-Nut Bread
Peanut-Chip-Banana-Bread-Food_com-188259	Peanut-Chip Banana Bread
Peanutbutter-Banana-Bread-Food_com-88855	Peanutbutter Banana Bread
Peanutty-Chocolate-Banana-Bread-Food_com-65919	Peanutty Chocolate Banana Bread
Pear-Banana-Bread-Food_com-72156	Pear Banana Bread
Pear-Banana-Bread-Low_fat-Recipezaar	Pear Banana Bread Low-Fat
Pennsylvania-Grange-Banana-Nut-Bread---Grange-_-1751-Food_com-134344	Pennsylvania Grange Banana Nut Bread - Grange # 1751
Penzeys-Banana-Bread-Recipezaar	Penzeys Banana Bread
Perfect-Banana-Bread-Food_com-182832	Perfect Banana Bread
Perfect-Banana-Bread-Recipezaar	Perfect Banana Bread
Perfect-Banana-Bread-Recipezaar_1	Perfect Banana Bread
Pineapple-Banana-Bread-Recipezaar	Pineapple Banana Bread
Pineapple-Banana-Bread-Recipezaar_1	Pineapple Banana Bread
Pineapple-Banana-Bread-TasteOfHome	Pineapple Banana Bread
Pineapple-Banana-Coconut-Bread-Food_com-71092	Pineapple Banana Coconut Bread
Pineapple-Banana-Sweet-Bread-Recipezaar	Pineapple Banana Sweet Bread
Pineapple-Banana-Walnut-Bread_muffins-Recipezaar	Pineapple Banana Walnut Bread/Muffins
Pink-Banana-Bread-Food_com-146851	Pink Banana Bread
Pistachio-Banana-Bread-Recipezaar	Pistachio Banana Bread
Plain-Ol_-Banana-Bread-_-Vegan-Recipezaar	Plain Ol' Banana Bread - Vegan
Pomegranate_-Banana-And-Pistachio-Bread-Recipezaar	Pomegranate, Banana and Pistachio Bread
Ponderosa-Banana-Chocolate-Bread-Recipezaar	Ponderosa Banana Chocolate Bread
Power-Banana-Bread-Food_com-132482	Power Banana Bread
Prize-Winning-Banana-Nut-Bread-Recipezaar	Prize Winning Banana Nut Bread
Pumpkin-Banana-Bread-Recipezaar	Pumpkin Banana Bread
Pumpkin-Banana-Bread-Recipezaar_1	Pumpkin Banana Bread
Pumpkin-Banana-Chocolate-Chip-Bread-Recipezaar	Pumpkin Banana Chocolate Chip Bread
Pumpkin-Banana-Cranberry-Bread-Recipezaar	Pumpkin Banana Cranberry Bread
Pumpkin-Banana-Zucchini-Spice-Bread-Recipezaar	Pumpkin Banana Zucchini Spice Bread
Queen-Valley-Banana-Bread-Recipezaar	Queen Valley Banana Bread
Quick-and-Easy-Eggless-Banana-Bread-Food_com-69280	Quick and Easy Eggless Banana Bread
Quick-Banana-Bread-Food_com-106455	Quick Banana Bread
Quick-Banana-Bread-Food_com-130613	Quick Banana Bread
Quick-Banana-Bread-Recipezaar	Quick Banana Bread
Quick-Banana-Bread-Recipezaar_1	Quick Banana Bread
Quick-Banana-Nut-Bread-Recipezaar	Quick Banana Nut Bread
Quick-Mix-Banana-Nut-Bread-AllRecipes-201820	Quick Mix Banana Nut Bread
Quick_-Easy_-Healthy_-Yummy-Banana-Bread-Recipezaar	Quick, Easy, Healthy, Yummy Banana Bread
Quinoa-Banana-Bread_-Regular-Or-Sugar-Free-Recipezaar	Quinoa Banana Bread, Regular or Sugar Free
Raised-Banana-Oatmeal-Bread-Recipezaar	Raised Banana Oatmeal Bread
Raisin-Banana-Bread-Food_com-178529	Raisin Banana Bread
Raisin-Banana-Bread-Recipezaar	Raisin Banana Bread
Raisin-Banana-Bread-TasteOfHome	Raisin Banana Bread
Raspberry-Banana-Bread-Allrecipes	Raspberry Banana Bread
Raspberry-Banana-Bread-Recipezaar	Raspberry Banana Bread
Raspberry_-Banana-_-Coconut-Bread_-Food_com-75614	Raspberry, Banana &amp; Coconut Bread.
Raspberry_banana-Oat-Bread-Recipezaar	Raspberry-Banana Oat Bread
Raw-Sugar-Banana-Bread-Recipezaar	Raw Sugar Banana Bread
Really-Low-Fat_-Low-Cholesterol-And-Low-Sugar-Banana-Bread-Recipezaar	Really Low Fat, Low Cholesterol and Low Sugar Banana Bread
Really-Rich-Banana-Bread-Allrecipes	Really Rich Banana Bread
Red-Banana-Pineapple-Bread-Serious-Eats-41796	Red Banana Pineapple Bread
Reduced-Cal-Splenda-Banana-Bread-Recipezaar	Reduced Cal Splenda Banana Bread
Reduced_calorie-Banana-Bread-Recipezaar	Reduced-Calorie Banana Bread
Reese_s-Peanut-Butter-Chocolate-Chip-Banana-Bread-Food_com-280318	Reese's Peanut Butter Chocolate Chip Banana Bread
Reese_s-Pieces-Peanut-Butter_banana-Bread-Recipezaar	Reese's Pieces Peanut Butter-Banana Bread
Regular-Size-Banana-Cranberry-Nut-Bread-Loaves-MyRecipes-238263	Regular-Size Banana-Cranberry-Nut Bread Loaves
Rice-Cooker-Banana-Bread-Food_com-141662	Rice Cooker Banana Bread
Rice-Flour-Banana-Bread-_wheat-Free_-Recipezaar	Rice Flour Banana Bread (Wheat Free)
Roasted-Banana-Bread-Food_com-149793	Roasted Banana Bread
Roasted-Banana-Bread-Pudding-With-Bourbon-Praline-Sauce-Food_com-72789	Roasted Banana Bread Pudding With Bourbon-Praline Sauce
Roasted-Pecan-Banana-Bread-Loaves-AllRecipes	Roasted Pecan Banana Bread Loaves
Rogene_s-Banana-Nut-Bread-_-See-Sharon_s-Note-Recipezaar	Rogene's Banana Nut Bread - See Sharon's Note
Rotten-Strawberry-Banana-Bread-Recipezaar	Rotten Strawberry Banana Bread
Rum-Banana-Bread-Recipezaar	Rum Banana Bread
Rum_-Caramel_-and-Banana-Bread-Pudding-Epicurious-53799	Rum, Caramel, and Banana Bread Pudding
Rum_-Caramel_-and-Banana-Bread-Pudding-Food_com-171125	Rum, Caramel, and Banana Bread Pudding
Sally_s-Chocolate-Chip-Banana-Bread-Recipezaar	Sally's Chocolate Chip Banana Bread
Sarah_s-Banana-Bread-Muffins-Allrecipes	Sarah's Banana Bread Muffins
Sarah_s-Blueberry-Banana-Bread-Recipezaar	Sarah's Blueberry Banana Bread
Sassy_s-Awesome-Banana-Bread-Recipezaar	Sassy's Awesome Banana Bread
Scrumptious-Banana-Bread-Recipezaar	Scrumptious Banana Bread
Scrumptious-Banana-Bread-Recipezaar_1	Scrumptious banana bread
Sesame-banana-bread-308613	Sesame Banana Bread
Sesame-Banana-Bread-Recipezaar	Sesame Banana Bread
Sheila_s-Banana-Bread-Food_com-141904	Sheila's Banana Bread
Shelli_s-Peanut-Butter-Banana-Bread-Food_com-151845	Shelli's Peanut Butter Banana Bread
Shelly_s-Banana-Bread-Recipezaar	Shelly's Banana Bread
Silky-Milky-Banana-Bread-For-Anu-Recipezaar	Silky Milky Banana Bread For Anu
Simple-Banana-Bread-2-Food_com-128817	Simple Banana Bread 2
Simple-Banana-Bread-Food_com-104524	Simple Banana Bread
Simple-Banana-Bread-Recipezaar	Simple Banana Bread
Simple-Banana-Bread-Recipezaar_1	Simple Banana Bread
Simple-Banana-Bread-Recipezaar_2	Simple Banana Bread
Simple-Banana-Chocolate-Chip-Bread-Recipezaar	Simple Banana Chocolate Chip Bread
Simple-Banana-Nut-Bread-Recipezaar	Simple Banana Nut  Bread
Simple-Banana_apple-Bread-Recipezaar	Simple Banana-Apple Bread
Simple-Bisquick-Banana-Bread-Recipezaar	Simple Bisquick Banana Bread
Simple-Vegan-Banana-Bread-Recipezaar	Simple Vegan Banana Bread
Simply-Delicious-Banana-Crumb-Bread-Allrecipes	Simply Delicious Banana Crumb Bread
Simply-Great-Banana-Bread-Recipezaar	Simply Great Banana Bread
Simply-the-Best-Above-All-the-Rest-Banana-Bread-Food_com-149922	Simply the Best Above All the Rest Banana Bread
Sinfully-Rich-_-Moist-Banana-Bread-Cake-Food_com-290571	Sinfully Rich &amp; Moist Banana Bread Cake
Skinny-Banana-Bread-Recipe-Chow-56422	Skinny Banana Bread Recipe
Slammin_-Banana-Bread-Food_com-132346	Slammin' Banana Bread
Slow-Cooked-Banana-Bread-Food_com-292983	Slow Cooked Banana Bread
Small-Batch-Banana-Nut-Bread-Recipezaar	Small Batch Banana Nut Bread
Something-Different-Banana-Bread-Recipezaar	Something Different Banana Bread
Sour-Cream-Banana-Bread-Food_com-78938	Sour Cream Banana Bread
Sour-Cream-Banana-Bread-Food_com-85766	Sour Cream-Banana Bread
Sour-Cream-Banana-Bread-Recipe-Chow-48134	Sour Cream&ndash;Banana Bread Recipe
Sour-Cream-Banana-Bread-Recipezaar	Sour Cream Banana Bread
Sour-Cream-Banana-Bread-Recipezaar_1	Sour Cream Banana Bread
Sour-Cream-Banana-Bread-Recipezaar_2	Sour Cream Banana Bread
Sour-Cream-Banana-Bread-Recipezaar_3	Sour Cream Banana Bread
Sour-Cream-Banana-Bread-Recipezaar_4	Sour Cream Banana Bread
Sour-Cream-Banana-Bread-Recipezaar_5	Sour Cream Banana Bread
Sour-Cream-Banana-Bread-With-Chocolate-Glaze-Food_com-83997	Sour Cream Banana Bread With Chocolate Glaze
Sour-Cream-Chocolate-Chocolate-Chip-Banana-Bread-Food_com-181942	Sour Cream Chocolate Chocolate Chip Banana Bread
Sourdough-Banana-Bread-Recipezaar	Sourdough Banana Bread
Southern-Banana-Nut-Bread-Food_com-153190	Southern Banana Nut Bread
Southern-Living_s-Cinnamon-Cream-Cheese-Banana-Nut-Bread-RecipeZaar-59721	Southern Living's Cinnamon Cream Cheese Banana Nut Bread
Southern-Living_s-Cream-Cheese-Banana-Bread-Recipezaar	Southern Living's Cream Cheese Banana Bread
Southern-Living_s-Cream-Cheese-Banana-Nut-Bread_healthier-Vers-Recipezaar	Southern Living's Cream Cheese Banana Nut Bread...healthier Vers
Southern-Living_s-Easiest-Banana-Bread-Ever-Recipezaar	Southern Living's Easiest Banana Bread Ever
Southern-Living_s-Toasted-Coconut-Cream-Cheese-Banana-Nut-Bread-RecipeZaar-59707	Southern Living's Toasted Coconut Cream Cheese Banana Nut Bread
Southern-Style-Banana-Bread-Recipezaar	Southern Style Banana Bread
Special-Banana-Bread-Allrecipes	Special Banana Bread
Special-Banana-Nut-Bread-Food_com-97053	Special Banana Nut Bread
Special-Banana-Nut-Bread-Recipezaar_1	Special Banana Nut Bread
Spelt-Banana-Bread-Recipezaar	Spelt Banana Bread
Spiced-Banana-Bread-Allrecipes	Spiced Banana Bread
Spiced-Banana-Bread-Food_com-144816	Spiced Banana Bread
Spiked-Banana-Bread-Food_com-179060	Spiked Banana Bread
Stacey_s-Homemade-Banana-Bread-Recipezaar	Stacey's Homemade Banana Bread
Stacie_s-Sour-Cream-Banana-Bread-Recipezaar	Stacie's Sour Cream Banana Bread
Staple-Banana-Bread-Food_com-169582	Staple Banana Bread
Starbucks-Banana-Bread-Recipezaar	Starbucks Banana Bread
Starbucks-Banana-Walnut-Bread-Food_com-63285	Starbucks Banana Walnut Bread
Starbucks-Banana-Walnut-Bread-Recipezaar	Starbucks Banana Walnut Bread
Stevia-Whole-Wheat-Banana-Bread-Food_com-117797	Stevia Whole Wheat Banana Bread
Strawberry-Banana-Bread-Pudding-Food-Network	Strawberry Banana Bread Pudding
Strawberry-Banana-Bread-Recipezaar	Strawberry Banana Bread
Strawberry-Banana-Bread-_-Disney-World-Recipezaar	Strawberry Banana Bread - Disney World
Strawberry-Banana-Macadamia-Bread-Recipezaar	Strawberry Banana Macadamia Bread
Strawberry-Banana-Nut-Bread-Food_com-151271	Strawberry-Banana Nut Bread
Strawberry-Banana-Nut-Bread-Food_com-72965	Strawberry Banana Nut Bread
Strawberry-Banana-Nut-Bread-Recipezaar	Strawberry Banana Nut Bread
Strawberry-Cake-Mix-Banana-Bread-Food_com-292719	Strawberry Cake Mix Banana Bread
Strawberry_banana-Bread-Recipezaar	Strawberry-Banana Bread
Strawberry_banana-Bread-Recipezaar_1	Strawberry-Banana Bread
Streusel-Topped-Banana-Bread-Food_com-182815	Streusel-Topped Banana Bread
Streusel-Topped-Banana-Nut-Bread-RecipeZaar-58640	Streusel Topped Banana Nut Bread
Stunning-Banana-Bread-Recipezaar	Stunning Banana Bread
St_-Martin-Banana-Bread-Recipezaar	St. Martin Banana Bread
Sugar-Free-Banana-Bread-Crumble-Food_com-181393	Sugar Free Banana Bread Crumble
Sugar-Free-Banana-Bread-Recipezaar	Sugar Free Banana Bread
Sugar-Free-Banana-Bread-Recipezaar_1	Sugar Free Banana Bread
Sugar-Free-Banana-Bread-_muffins_-Recipezaar	Sugar Free Banana Bread (Muffins)
Sugar-Free_-Gluten-Free_-Low-Fat-Peanut-Butter-Banana-Bread-Recipezaar	Sugar Free, Gluten Free, Low Fat Peanut Butter Banana Bread
Super-Antioxidant-Blueberry-Banana-Chocolate-Chip-Bread-Recipezaar	Super Antioxidant Blueberry Banana Chocolate Chip Bread
Super-Cheap-Banana-Bread-Recipezaar	Super Cheap Banana Bread
Super-Easy-Ultimate-Banana-Bread-Recipezaar	Super Easy Ultimate Banana Bread
Super-Healthy-Whole-Wheat-Honey-Flax-Banana-Nut-Bread-Recipezaar	Super Healthy Whole Wheat Honey Flax Banana Nut Bread
Super-Moist-Banana-Bread-Recipezaar	Super Moist Banana Bread
Super-Moist-Banana-Bread-Recipezaar_1	Super Moist Banana Bread
Super-Moist-Banana-Bread-Recipezaar_2	Super Moist Banana Bread
Super-Moist-Banana-Chocolate-Chip-Bread-Food_com-171989	Super Moist Banana Chocolate Chip Bread
Super-Moist-Spiced-Banana-Nut-Bread-Food_com-66476	Super Moist Spiced Banana Nut Bread
Super-Moist-Super-Easy-Banana-Bread-_-Oamc-Recipezaar	Super Moist Super Easy Banana Bread - OAMC
Super-Moist-Vegan-Banana-Bread-Recipezaar	Super Moist Vegan Banana Bread
Super-Moist-_-Amazing-Banana-Bread-Food_com-107886	Super Moist &amp; Amazing Banana Bread
Super-Special-Banana-Bread-Two-Ways-Food_com-67516	Super-Special Banana Bread Two Ways
Super_moist-100_-Whole-Wheat-Banana-Currant-Bread-Recipezaar	Super-Moist 100% Whole Wheat Banana Currant Bread
Sweet-Banana-Bread-Allrecipes	Sweet Banana Bread
Sweet-Banana-Bread-Recipezaar	Sweet Banana Bread
Tarrah_s-Healthy-Banana-Bread-Recipezaar	Tarrah's Healthy Banana Bread
Tasty-Banana-Bread-Recipezaar	Tasty Banana Bread
Tasty-Gluten-Free-Banana-Bread-Or-Muffins-Recipezaar	Tasty Gluten Free Banana Bread or Muffins
Tasty-Low-Fat-Banana-Bread-Food_com-185409	Tasty Low Fat Banana Bread
Tasty-Vegan-Banana-Bread-Recipezaar	Tasty Vegan Banana Bread
Terrys-Banana-Bread-Recipezaar	Terrys Banana Bread
The-Best-And-Easiest-Banana-Nut-Bread-Recipezaar	The Best and Easiest Banana Nut Bread
The-Best-Banana-Bread-Allrecipes	The Best Banana Bread
The-Best-Banana-Bread-Food_com-164830	The Best Banana Bread
The-Best-Banana-Bread-Recipezaar	The BEST Banana Bread
The-Best-Banana-Bread-Recipezaar_1	The Best Banana Bread
The-Best-Banana-Bread-Recipezaar_2	The Best Banana Bread
The-Best-Banana-Bread-Recipezaar_3	The Best Banana Bread
The-Best-Banana-Bread-_And-It_s-Healthy_--Ww-Friendly_-Food_com-176281	The Best Banana Bread (And It's Healthy!  Ww Friendly!)
The-Best-Banana-Bread-_cook_s-Illustrated_-Recipezaar	The Best Banana Bread (Cook's Illustrated)
The-Best-Banana-Bread-_No-Kidding_-Food_com-177705	The Best Banana Bread (No Kidding!)
The-Best-Banana-Cake-_-Bread-Recipezaar	The Best Banana Cake / Bread
The-Best-Banana-Nut-Bread-Recipezaar	The Best Banana Nut Bread
The-Best-Banana-Nut-Bread-Recipezaar_1	The Best Banana Nut Bread
The-Best-Butterscotch-Banana-Bread-Recipezaar	The Best Butterscotch Banana Bread
The-Easiest-Banana-Bread-Recipezaar	The Easiest Banana Bread
The-Easiest-Bisquick-Banana-_nut-_-Bread-Recipezaar	The Easiest Bisquick Banana (Nut ) Bread
The-Greatest-Banana-Bread-Allrecipes	The Greatest Banana Bread
The-Healthy-Version-Of-Going-Bananas-Bread-Recipezaar	The Healthy Version of Going Bananas Bread
The-Moistest-Banana-Bread-_W_-Jar-Baking-Instructions_-Food_com-123923	The Moistest Banana Bread (W/ Jar Baking Instructions)
The-Ultimate-Reese_s-Peanut-Butter-Banana-Bread-Recipezaar	The Ultimate Reese's Peanut Butter Banana Bread
The-Very-Best-Banana-Cranberry-Bread-Recipezaar	The Very Best Banana Cranberry Bread
The-Worlds-Bestest-Banana-Bread-Recipezaar	The Worlds Bestest Banana Bread
Thermomix-Banana-Banana-Bread-Recipezaar	Thermomix Banana Banana Bread
To-Die-For-Banana-Bread-Recipezaar	To Die for Banana Bread
Toasted-Coconut_cream-Cheese_banana_nut-Bread-My-Recipes	Toasted Coconut-Cream Cheese-Banana-Nut Bread
Toasted-Coconut_topped-Cream-Cheese_banana_nut-Bread-My-Recipes	Toasted Coconut-Topped Cream Cheese-Banana-Nut Bread
Toffee_-Banana-Rum-Bread-Recipezaar	Toffee- Banana Rum Bread
Tom_s-Favorite-Banana-Bread-Recipezaar	Tom's Favorite Banana Bread
Toni_s-Banana-Bread-My-Recipes	Toni's Banana Bread
Toni_s-Banana-Chocolate-Chip-Walnut-Bread-My-Recipes	Toni's Banana Chocolate Chip Walnut Bread
Triple-Banana-Chippy-Bread-Or-Muffins-Recipezaar	Triple Banana Chippy Bread or Muffins
Tropical-Banana-Bread-Muffins-My-Recipes	Tropical Banana Bread Muffins
Tropical-Banana-Bread-Recipezaar	Tropical Banana Bread
Tropical-Banana-Bread-Recipezaar_1	Tropical Banana Bread
Tropical-Banana-Bread-Recipezaar_2	Tropical Banana Bread
Tropical-banana-bread-with-macadamia-nuts_-pineapple_-and-coconut-308485	Tropical Banana Bread with Macadamia Nuts, Pineapple, and Coconut
Tropical-Banana-Bread_muffins-Recipezaar	Tropical Banana Bread-Muffins
Tropical-Banana-Quick-Bread-My-Recipes	Tropical Banana Quick Bread
Tropical-Swirlin_-Spice-Banana-Nut-Bread-Food_com-144889	Tropical Swirlin' Spice Banana Nut Bread
Truely-Banana-Bread-Recipezaar	Truely Banana Bread
Twice-The-Banana-Bread-Recipezaar	Twice the Banana Bread
Two_tone-Banana-Bread-For-Chocolate-Lovers_-Recipezaar	Two-Tone Banana Bread for Chocolate Lovers!
Ultimate-Banana-Bread-Food_com-117217	Ultimate Banana Bread
Ultimate-Banana-Bread-Recipezaar	Ultimate Banana Bread
Ultimate-Banana-Nut-Bread-_cake_-Recipezaar	Ultimate Banana Nut Bread (Cake?)
Uncle-Dobo_s-Special-Banana-Blueberry-Bread-Recipezaar	Uncle Dobo&rsquo;s Special Banana Blueberry Bread
Uncooked-Banana-Bread-Recipezaar	Uncooked Banana Bread
Unique-and-Yummy-Banana-Crunch-Bread-Food_com-86754	Unique and Yummy Banana Crunch Bread
Val_s-Banana-Bread-Food_com-79564	Val's Banana Bread
Vanilla-Banana-Bread-Recipezaar	Vanilla Banana Bread
Vegan-Banana-Bread-Recipezaar	Vegan Banana Bread
Vegan-Banana-Bread-Recipezaar_1	Vegan Banana Bread
Vegan-Banana-Bread-Recipezaar_2	Vegan Banana Bread
Vegan-Banana-Bread-Recipezaar_3	Vegan Banana Bread
Vegan-Banana-Bread-_healthy_-Recipezaar	Vegan Banana Bread (Healthy!)
Vegan-Banana-Chocolate-Chip-Walnut-Bread-Food_com-169967	Vegan Banana Chocolate Chip Walnut Bread
Vegan-Banana-Chocolate-Spice-Bread-Food_com-162857	Vegan Banana Chocolate Spice Bread
Vegan-Chocolate-Chip-Banana-Bread-Recipezaar	Vegan Chocolate Chip Banana Bread
Vegan-Gf-Banana-Bread-Food_com-179234	Vegan Gf Banana Bread
Vegan-Low_fat-Banana-Bread-Recipezaar	Vegan Low-Fat Banana Bread
Vegan-Spelt-Banana-Bread-Recipezaar	Vegan Spelt Banana Bread
Very-Banana-Bread-Food_com-117557	Very Banana Bread
Very-Low-Calorie-Banana-Bread-Food_com-123735	Very Low Calorie Banana Bread
Very-Moist-Banana-Bread-Food_com-110833	Very Moist Banana Bread
Very-Moist-Banana-Nut-Bread-Recipezaar	Very Moist Banana Nut Bread
Very-Moist-Whole-Wheat-Banana-Bread-Recipezaar	Very Moist Whole Wheat Banana Bread
Very-Peanutty-Chocolate-Banana-Bread-Recipezaar	Very Peanutty Chocolate Banana Bread
Very-Vanilla-Banana-Bread-Recipezaar	Very Vanilla Banana Bread
Virginia_s-Banana-Bread-Recipezaar	Virginia's Banana Bread
Virtually-Fat-Free-Banana-Bread-Recipezaar	Virtually Fat Free Banana Bread
Walnut-Banana-Bread-AllRecipes-39731	Walnut Banana Bread
Walnut-Banana-Bread-Pudding-AllRecipes-202593	Walnut Banana Bread Pudding
Walnut-Chip-Banana-Bread-Food_com-138482	Walnut Chip Banana Bread
We-Be-Jammin_-Jamaican-Banana-Bread-Allrecipes	We Be Jammin' Jamaican Banana Bread
Weight-Watcher-1-Point-Banana-Bread_flex-Points-Recipezaar	Weight Watcher 1 Point Banana Bread--Flex Points
Weight-Watcher-Friendly-Banana-Bread-_Low-Fat_-Food_com-86960	Weight Watcher Friendly Banana Bread (Low Fat)
Weight-Watchers-West-Indies-Banana-Bread-Recipezaar	Weight Watchers West Indies Banana Bread
Wheat-Banana-Bread-Recipezaar	Wheat Banana Bread
Wheat-Banana-Bread-_Bread-Machine_-Food_com-288072	Wheat Banana Bread (Bread Machine)
Wheat_free_-Dairy_free-Banana-Bread-Recipezaar	Wheat-free, Dairy-free Banana Bread
Where-Old-Bananas-Go-to-Die-Bread-Food_com-91046	Where Old Bananas Go to Die Bread
Whipped-Up-Nutmeg-Banana-Bread-_eggless_-Recipezaar	Whipped up Nutmeg Banana Bread (Eggless)
White-Chocolate-Banana-Bread-Pudding-Food-Network	White Chocolate Banana Bread Pudding
White-Chocolate-Banana-Bread-Pudding-Food_com-111249	White Chocolate Banana Bread Pudding
White-Chocolate-Banana-Bread-Recipezaar	White Chocolate Banana Bread
White-Chocolate-Banana-Bread-Recipezaar_1	White Chocolate Banana Bread
White-Chocolate-Chip-Cranberry-Banana-Bread-With-Coconut-Flour-Food_com-90497	White Chocolate Chip Cranberry Banana Bread With Coconut Flour
Whole-Grain-Banana-Coconut-Bread-Recipezaar	Whole Grain Banana Coconut Bread
Whole-Grain-Chocolate-Chip-Banana-Bread-Food_com-180053	Whole Grain Chocolate Chip Banana Bread
Whole-Grain-Healthy-Banana-Bread-Allrecipes	Whole Grain Healthy Banana Bread
Whole-Grain-Kefir-Banana-Bread-Recipe-Chow-48325	Whole Grain Kefir Banana Bread Recipe
Whole-Grain-Kefir-Banana-Bread-Recipezaar	Whole Grain Kefir Banana Bread
Whole-Wheat-Banana-Bread-Food_com-125442	Whole Wheat Banana Bread
Whole-Wheat-Banana-Bread-Food_com-91319	Whole Wheat Banana Bread
Whole-Wheat-Banana-Bread-Mini-Muffins-Recipezaar	Whole Wheat Banana Bread Mini Muffins
Whole-Wheat-Banana-Bread-My-Recipes	Whole Wheat Banana Bread
Whole-Wheat-Banana-Bread-Recipezaar	Whole Wheat Banana Bread
Whole-Wheat-Banana-Bread-Recipezaar_1	Whole Wheat Banana Bread
Whole-Wheat-Banana-Bread-Recipezaar_2	Whole Wheat Banana Bread
Whole-Wheat-Banana-Bread-Recipezaar_3	Whole Wheat Banana Bread
Whole-Wheat-Banana-Bread-Recipezaar_4	Whole Wheat Banana Bread
Whole-Wheat-Banana-Bread-TasteOfHome	Whole Wheat Banana Bread
Whole-Wheat-Banana-Nut-Bread-Allrecipes	Whole Wheat Banana Nut Bread
Whole-Wheat-Banana-Nut-Bread-Food_com-169208	Whole Wheat Banana Nut Bread
Whole-Wheat-Banana-Nut-Bread-Recipezaar	Whole Wheat Banana Nut Bread
Whole-Wheat-Banana-Snack-Bread-Recipezaar	Whole Wheat Banana Snack Bread
Whole-Wheat-Chocolate-Banana-Bread-AllRecipes	Whole Wheat Chocolate Banana Bread
Whole-Wheat-Chocolate-Chip-Banana-Bread-Recipezaar	Whole Wheat Chocolate Chip Banana Bread
Whole-Wheat-Cornmeal-Molasses-Banana-Bread-Recipezaar	Whole Wheat Cornmeal Molasses Banana Bread
Whole-Wheat-Date-Walnut-Banana-Bread-Recipezaar	Whole Wheat Date Walnut Banana Bread
Whole-Wheat-Healthy-Banana-Bread-Recipezaar	Whole Wheat Healthy Banana Bread
Whole-Wheat-Honey-Banana-Bread-Recipe-Recipezaar	Whole Wheat Honey Banana Bread Recipe
Whole-Wheat-Honey-Banana-Bread-Recipezaar	Whole Wheat Honey Banana Bread
Whole-Wheat-Honey-Banana-Bread-_for-Bread-Machine_-Recipezaar	Whole Wheat Honey Banana Bread (For Bread Machine)
Whole-Wheat-Oat-Banana-Bread-Recipezaar	Whole Wheat Oat Banana Bread
Whole-Wheat-Organic-Banana-Nut-Bread-With-Raisins-Recipezaar	Whole Wheat Organic Banana Nut Bread With Raisins
Whole-Wheat-Peanut-Butter_banana-Bread-With-Chocolate-Chips-Recipezaar	Whole Wheat Peanut Butter-Banana Bread With Chocolate Chips
Whole-Wheat-_-Healthy-Banana-Nut-Bread-Food_com-182291	Whole Wheat &amp; Healthy Banana Nut Bread
Whole-Wheat-_-Soymilk-Banana-Bread-Recipezaar	Whole Wheat &amp; Soymilk Banana Bread
Whole_grain-Zucchini-Banana-Bread-Recipezaar	Whole-Grain Zucchini Banana Bread
William-Shatner_s-Banana-Nut-Bread-Recipezaar	William Shatner's Banana Nut Bread
Winter-Squash-Banana-Bread-Food_com-110619	Winter Squash Banana Bread
Wonderful-Banana-Bread-Recipezaar	Wonderful Banana Bread
Wonderful-Banana-Bread-Recipezaar_1	Wonderful Banana Bread
World_s-Best-Banana-Bread_-Recipezaar	World's Best Banana Bread!
Ww-2-Point-Banana-Bread-Recipezaar	Ww 2 Point Banana Bread
Ww-2-Points-_-Frosted-Banana-Bread-Muffins-Recipezaar	Ww 2 Points - Frosted Banana Bread Muffins
Ww-2-Points-_-Pumpkin-Banana-Bread-Recipezaar	Ww 2 Points - Pumpkin Banana Bread
Ww-Banana-Bread-Recipezaar	Ww Banana Bread
XoBanana-Bread-Adam Green-55400	XoBanana Bread
Xobanana-bread-made-with-xocai-healthy-dark-chocolate-302755	XoBanana Bread made with Xocai Healthy Dark Chocolate
Yankee-Banana-Bread-Recipezaar	Yankee Banana Bread
Yeah_-But-My-Vegan-Banana-Bread-Has-No-Soy_-No-Margarine-Either-Recipezaar	Yeah, but My Vegan Banana Bread Has No Soy, No Margarine Either
Yes_-Another-Banana-Bread_muffin-Recipe-Recipezaar	Yes, Another Banana Bread/Muffin Recipe
Yet---Another-Banana-Bread-Food_com-76851	Yet   Another Banana Bread
Yet-Another-Banana-Bread-Recipe-Recipezaar	Yet   Another Banana Bread Recipe
Yogurt-Banana-Bread-Recipezaar	Yogurt Banana Bread
Yogurt-Banana-Bread-Recipezaar_1	Yogurt Banana Bread
Yuletide-Banana-Bread-TasteOfHome	Yuletide Banana Bread
Yum-Yum-Banana-Bread-Recipezaar	Yum Yum Banana Bread
Yummmmmiest-Banana-Bread-Recipezaar	Yummmmmiest Banana Bread
Yummy-Banana-Bread-Food_com-111274	Yummy Banana Bread
Yummy-Banana-Bread-Recipezaar	Yummy Banana Bread
Yummy-Banana-Bread-Recipezaar_1	Yummy Banana Bread
Yummy-Banana-Bread-Recipezaar_2	Yummy Banana Bread
Yummy-Banana-Bread-Recipezaar_3	Yummy Banana Bread
Yummy-Banana-Bread-Recipezaar_4	Yummy Banana Bread
Yummy-Banana-Nut-Bread-Food_com-167537	Yummy Banana Nut Bread
Yummy-Healthy-Banana-Bread-Recipezaar	Yummy Healthy Banana Bread
Yummy-Mini-Banana-Bread-Recipezaar	Yummy Mini Banana Bread
Yummy-Peanut-Butter-Cup-and-Banana-Bread-Food_com-153441	Yummy Peanut Butter Cup and Banana Bread
Zoobana-_zucchini-Banana_-Bread-Recipezaar	Zoobana (Zucchini Banana) Bread
Zucchini-Banana-Bread-Food_com-120390	Zucchini Banana Bread
Zucchini-Banana-Bread-Food_com-131803	Zucchini Banana Bread
Zucchini-Banana-Bread-Food_com-70539	Zucchini Banana Bread
Zucchini-Banana-Bread-Recipezaar	Zucchini Banana Bread
Zucchini-Banana-Bread-Recipezaar_1	Zucchini Banana Bread
Zucchini-Banana-Bread-Recipezaar_2	Zucchini Banana Bread
Zucchini-Banana-Bread-Recipezaar_3	Zucchini Banana Bread
Zucchini-Banana-Oat-Bread-_low_er_-Carb_-Recipezaar	Zucchini Banana Oat Bread (Low(Er) Carb)
Zucchini_banana_pumpkin-Bread-Recipezaar	Zucchini-Banana-Pumpkin Bread
_beat-This_-Banana-Bread-Recipezaar	"Beat This" Banana Bread
_Herman-Starter_-Sourdough-Banana-Bread-Food_com-96887	(Herman Starter) Sourdough Banana Bread
_modified_-Banana-Bread-By-Paula-Deen-Recipezaar	(Modified) Banana Bread by Paula Deen
_mom_s-Amazing-Banana-Bread_-Food_com-63059	&quot;mom's Amazing Banana Bread&quot;
_spicy_-Banana-Bread-Recipezaar	&quot;Spicy&quot; Banana Bread
_the-Best_-Banana-Bread-_or-Muffins_-Recipezaar	"The Best" Banana Bread (or Muffins!)
_we_re-Going-Bananas_-Bread-Recipezaar	&quot;we're Going Bananas&quot; Bread